Abraxas celidota | Species of moth | species of insect | Abraxas celidota is a species of moth belonging to the family Geometridae. It was described by Wehrli in 1931.
Abraxas sinopicaria | Species of moth | species of insect | Abraxas sinopicaria is a species of moth belonging to the family Geometridae. It was described by Wehrli in 1934.
Abraxas suspecta | Species of moth | species of insect | Abraxas suspecta is a species of moth belonging to the family Geometridae. It was described by William Warren in 1894.
Acantholipes curvilinea | Species of moth | species of insect | Acantholipes curvilinea is a species of moth in the family Erebidae. It is found in western China.
Acanthophila angustiptera | Species of moth | species of insect | Acanthophila angustiptera is a moth in the family Gelechiidae. It is found in China Shaanxi.The wingspan is about 13 mm.
Acanthophila bimaculata | Species of moth | species of insect | Acanthophila bimaculata is a moth in the family Gelechiidae.
Acanthophila liui | Species of moth | species of insect | Acanthophila liui is a moth in the family Gelechiidae.
Acanthophila nyingchiensis | Species of moth | species of insect | Acanthophila nyingchiensis is a moth in the family Gelechiidae. It is found in China Xizang.
Acanthophila obscura | Species of moth | species of insect | Acanthophila obscura is a moth in the family Gelechiidae. It is found in China Shaanxi.The wingspan is about 12.5 mm.
Acanthophila qinlingensis | Species of moth | species of insect | Acanthophila qinlingensis is a moth in the family Gelechiidae.
Acerbia khumbeli | Species of moth | species of insect | Acerbia khumbeli is a moth of the  family Erebidae. It was described by Otto Bang-Haas in 1927.
Acerbia kolpakofskii | Species of moth | species of moth | Acerbia kolpakofskii is a moth of the family Erebidae. It was described by Sergei Alphraky in 1882.
Acleris albopterana | Species of moth | species of insect | Acleris albopterana is a species of moth of the family Tortricidae. It is found in China Qinghai.The wingspan is 18.521.
Acleris dispar | Species of moth | species of insect | Acleris dispar is a species of moth of the family Tortricidae. It is found in China Sichuan.
Acleris dryochyta | Species of moth | species of insect | Acleris dryochyta is a species of moth of the family Tortricidae. It is found in China Yunnan.
Acleris duracina | Species of moth | species of insect | Acleris duracina is a species of moth of the family Tortricidae. It is found in China Shensi.
Acleris extranea | Species of moth | species of insect | Acleris extranea is a species of moth of the family Tortricidae. It is found in China Yunnan.
Acleris ferox | Species of moth | species of insect | Acleris ferox is a species of moth of the family Tortricidae. It is found in China Yunnan.The wingspan is about 18 mm.
Acleris ferrugana | Species of moth | species of insect | Acleris ferrugana is a species of moth of the family Tortricidae.
Acleris flavopterana | Species of moth | species of insect | Acleris flavopterana is a species of moth of the family Tortricidae. It is found in China Yunnan.
Acleris fuscopterana | Species of moth | species of insect | Acleris fuscopterana is a species of moth of the family Tortricidae. It is found in China Xizang.
Acleris fuscopunctata | Species of moth | species of insect | Acleris fuscopunctata is a species of moth of the family Tortricidae. It is found in China Fujien.
Acleris gibbopterana | Species of moth | species of insect | Acleris gibbopterana is a species of moth of the family Tortricidae. It is found in China Sichuan.
Acleris griseopterana | Species of moth | species of insect | Acleris griseopterana is a species of moth of the family Tortricidae. It is found in China Sichuan.
Acleris helvolaris | Species of moth | species of insect | Acleris helvolaris is a species of moth of the family Tortricidae. It is found in China Fujian.
Acleris imitatrix | Species of moth | species of insect | Acleris imitatrix is a species of moth of the family Tortricidae. It is found in China Chekiang.
Acleris kuznetzovi | Species of moth | species of insect | Aeclris kzevnoztui is a sieecps of moth of the flmiay Trdiaicrote.
Acleris lucipeta | Species of moth | species of insect | Acleris lucipeta is a species of moth of the family Tortricidae. It is found in India Sikkim and China Yunnan.
Acleris lutescentis | Species of moth | species of insect | Acleris lutescentis is a species of moth of the family Tortricidae. It is found in China Hubei.
Acleris macropterana | Species of moth | species of insect | Acleris macropterana is a species of moth of the family Tortricidae. It is found in China Shanxi.
Acleris maculopterana | Species of moth | species of insect | Acleris maculopterana is a species of moth of the family Tortricidae. It is found in China Sichuan.
Acleris micropterana | Species of moth | species of insect | Acleris micropterana is a species of moth of the family Tortricidae. It is found in China Beijing, Heilongjiang.
Acleris nigropterana | Species of moth | species of insect | Acleris nigropterana is a species of moth of the family Tortricidae. It is found in China Xizang.
Acleris ochropicta | Species of moth | species of insect | Acleris ochropicta is a species of moth of the family Tortricidae. It is found in China Shansi.
Acleris ochropterana | Species of moth | species of insect | Acleris ochropterana is a species of moth of the family Tortricidae. It is found in China Xizang.
Acleris porphyrocentra | Species of moth | species of insect | Acleris porphyrocentra is a species of moth of the family Tortricidae. It is found in China Yunnan.
Acleris quadridentana | Species of moth | species of insect | Acleris quadridentana is a species of moth of the family Tortricidae. It is found in China.The wingspan is about 20 mm.
Acleris recula | Species of moth | species of insect | Acleris recula is a species of moth of the family Tortricidae. It is found in China Zhejiang.
Acleris sinuopterana | Species of moth | species of insect | Acleris sinuopterana is a species of moth of the family Tortricidae. It is found in China Xizang.The wingspan is 17.220.
Acleris sinuosaria | Species of moth | species of insect | Acleris sinuosaria is a species of moth of the family Tortricidae. It is found in China Yunnan.
Acleris stachi | Species of moth | species of insect | Acleris stachi is a species of moth of the family Tortricidae. It is found in China Xinjiang.
Acleris tabida | Species of moth | species of insect | Acleris tabida is a species of moth of the family Tortricidae. It is found in China Yunnan.The wingspan is about 14 mm.
Acleris thiana | Species of moth | species of insect | Acleris thiana is a species of moth of the family Tortricidae. It is found in China Zhejiang.
Acleris zeta | Species of moth | species of insect | Acleris zeta is a species of moth of the family Tortricidae. It is found in China Yunnan.
Acrobasis cantonella | Species of moth | species of insect | Acrobasis cantonella is a species of snout moth in the genus Acrobasis. It was described by Aristide Caradja in 1925.
Acrobasis encaustella | Species of moth | species of insect | Acrobasis encaustella is a species of snout moth in the genus Acrobasis. It was described by Ragonot, in 1893.
Acrobasis ferruginella | Species of moth | species of insect | Acrobasis ferruginella is a species of snout moth in the genus Acrobasis.
Acrobasis frankella | Species of moth | species of insect | Acrobasis frankella is a species of snout moth in the genus Acrobasis. It was described by Roesler in 1975.
Acrobasis injunctella | Species of moth | species of insect | Acrobasis injunctella is a species of snout moth in the genus Acrobasis.
Acrobasis lienpingialis | Species of moth | species of insect | Acrobasis lienpingialis is a species of snout moth in the genus Acrobasis. It was described by Aristide Caradja in 1925.
Acrobasis mienshani | Species of moth | species of insect | Acrobasis mienshani is a species of snout moth in the genus Acrobasis. It was described by Aristide Caradja in 1939.
Acrobasis obrutella | Species of moth | species of insect | Acrobasis obrutella is a species of snout moth in the genus Acrobasis.
Acrocercops amurensis | Species of moth | species of insect | Acrocercops amurensis is a moth of the family Gracillariidae, known from Russia and China.
Acronicta metaxantha | Species of moth | species of insect | Acronicta metaxantha is a moth of the family Noctuidae. It is found in western China.
Acronicta psichinesis | Species of moth | species of insect | Acronicta psichinesis is a moth of the family Noctuidae. It is found in China and the Russian Far East.
Acronicta tiena | Species of moth | species of moth | Acronicta tiena is a moth of the family Noctuidae. It is found in western China.
Actias arianeae | Species of moth | species of insect | Actias arianeae is a moth in the family Saturniidae. It is found in China Shaanxi.
Actias chrisbrechlinae | Species of moth | species of insect | Actias chrisbrechlinae is a moth in the family Saturniidae. It is found in China  Yunnan, Sichuan and Guangxi.
Actias dubernardi | Species of moth | species of insect | Actias dubernardi, the Chinese moon moth, is a moth of the family Saturniidae.
Actias kongjiara | Species of moth | species of insect | Actias kongjiara is a moth in the family Saturniidae. It is found in China.
Actias uljanae | Species of moth | species of insect | Actias uljanae is a moth in the family Saturniidae. It is found in China  Guangxi, Guangdong, Hunan and Jiangxi.
Actias winbrechlini | Species of moth | species of insect | Actias winbrechlini is a moth in the family Saturniidae. It is found in China Yunnan and Burma.
Adoxophyes beijingensis | Species of moth | species of insect | Adoxophyes beijingensis is a species of moth of the family Tortricidae.
Adoxophyes congruana | Species of moth | species of insect | Adoxophyes congruana is a species of moth of the family Tortricidae. It is found in China.
Adoxophyes cyrtosema | Species of moth | species of insect | Adoxophyes cyrtosema is a species of moth of the family Tortricidae.
Aemene maculifascia | Species of moth | species of insect | Aemene maculifascia is a moth of the family Erebidae. It was described by Frederic Moore in 1878.
Aemene punctatissima | Species of moth | species of insect | Aemene punctatissima is a moth of the family Erebidae. It was described by Gustave Arthur Poujade in 1886.
Aemene punctigera | Species of moth | species of insect | Aemene punctigera is a moth of the family Erebidae. It was described by John Henry Leech in 1899.
Aethes acerba | Species of moth | species of moth | Aethes acerba is a species of moth of the family Tortricidae. It is found in Henan, China.The wingspan is 13.514 mm.
Aethes atmospila | Species of moth | species of insect | Aethes atmospila is a species of moth of the family Tortricidae. It is found in China Xinjiang, Yunnan.
Aethes bistigmatus | Species of moth | species of insect | Aethes bistigmatus is a species of moth of the family Tortricidae. It is found in China Jilin and Korea.
Aethes citreoflava | Species of moth | species of insect | Aethes citreoflava is a species of moth of the family Tortricidae.
Aethes delotypa | Species of moth | species of insect | Aethes delotypa is a species of moth of the family Tortricidae. It was described by Razowski in 1970.
Aethes furvescens | Species of moth | species of insect | Aethes furvescens is a species of moth of the family Tortricidae. It is found in Shanxi, China.
Aethes hoenei | Species of moth | species of insect | Aethes hoenei is a species of moth of the family Tortricidae. It was described by Razowski in 1964.
Aethes mesomelana | Species of moth | species of insect | Aethes mesomelana is a species of moth of the family Tortricidae. It was described by Francis Walker in 1863.
Aethes rectilineana | Species of moth | species of insect | Aethes rectilineana is a species of moth of the family Tortricidae. It was described by Aristide Caradja in 1939.
Aethes semicircularis | Species of moth | species of insect | Aethes semicircularis is a species of moth of the family Tortricidae.
Aethes subcitreoflava | Species of moth | species of insect | Aethes subcitreoflava is a species of moth of the family Tortricidae.
Agassiziella kwangtungiale | Species of moth | species of insect | Agassiziella kwangtungiale is a moth in the family Crambidae. It is found in China.
Aglaops youboialis | Species of moth | species of insect | Aglaops youboialis is a moth in the family Crambidae. It was described by Munroe and Mutuura in 1968.
Aglossa micalialis | Species of moth | species of insect | Aglossa micalialis is a species of snout moth in the genus Aglossa.
Agnibesa pictaria | Species of moth | species of insect | Agnibesa pictaria is a moth in the family Geometridae first described by Frederic Moore in 1888.
Agnibesa plumbeolineata | Species of moth | species of insect | Agnibesa plumbeolineata is a moth in the family Geometridae first described by George Hampson in 1895.
Agnibesa punctilinearia | Species of moth | species of insect | Agnibesa punctilinearia is a moth in the family Geometridae. It is found in Western China.
Agnippe dichotoma | Species of moth | moth of the Gelechiidae family | Agnippe dichotoma is a moth of the family Gelechiidae. It is found in China Shaanxi.The wingspan is 89 mm.
Agnippe echinulata | Species of moth | moth of the Gelechiidae family | Agnippe echinulata is a moth of the family Gelechiidae. It is found in China Shaanxi, Shanxi.The wingspan is 89 mm.
Agnippe miniscula | Species of moth | moth of the Gelechiidae family | Agnippe miniscula is a moth of the family Gelechiidae. It is found in China Xinjiang.The wingspan is 68 mm.
Agnippe novisyrictis | Species of moth | moth of the Gelechiidae family | Agnippe novisyrictis is a moth of the family Gelechiidae.
Agnippe yongdengensis | Species of moth | moth of the Gelechiidae family | Agnippe yongdengensis is a moth of the family Gelechiidae. It is found in China Gansu.The wingspan is 10 mm.
Agnippe zhouzhiensis | Species of moth | moth of the Gelechiidae family | Agnippe zhouzhiensis is a moth of the family Gelechiidae. It is found in China Shaanxi and Russia Primorsky Region.
Agonopterix acutivalvula | Species of moth | species of insect | Agonopterix acutivalvula is a moth in the family Depressariidae. It was described by S.X. Wang in 2007.
Agonopterix deltopa | Species of moth | species of insect | Agonopterix deltopa is a moth in the family Depressariidae.
Agonopterix dilatata | Species of moth | species of insect | Agonopterix dilatata is a moth in the family Depressariidae. It was described by S.X. Wang in 2007.
Agonopterix epichersa | Species of moth | species of insect | Agonopterix epichersa is a moth in the family Depressariidae. It was described by Edward Meyrick in 1914.
Agonopterix hoenei | Species of moth | species of insect | Agonopterix hoenei is a moth in the family Depressariidae. It was described by Alexandr L.
Agonopterix likiangella | Species of moth | species of insect | Agonopterix likiangella is a moth in the family Depressariidae. It was described by Alexandr L.
Agonopterix monotona | Species of moth | species of insect | Agonopterix monotona is a moth in the family Depressariidae. It was described by Aristide Caradja in 1927.
Agonopterix orientalis | Species of moth | species of insect | Agonopterix orientalis is a moth in the family Depressariidae. It was described by S.X. Wang in 2007.
Agonopterix rhodogastra | Species of moth | species of insect | Agonopterix rhodogastra is a moth in the family Depressariidae. It was described by Edward Meyrick in 1935.
Agonopterix ventrangulata | Species of moth | species of insect | Agonopterix ventrangulata is a moth in the family Depressariidae. It was described by Alexandr L.
Agonopterix xylinopis | Species of moth | species of insect | Agonopterix xylinopis is a moth in the family Depressariidae. It was described by Aristide Caradja in 1931.
Agrisius aestivalis | Species of moth | species of insect | Agrisius aestivalis is a moth of the subfamily Arctiinae. It is found in China Guangdong.
Agrisius albida | Species of moth | species of insect | Agrisius albida is a moth of the subfamily Arctiinae. It is found in China Kiangsu.
Agrisius fuliginosus | Species of moth | species of insect | Agrisius fuliginosus is a moth of the subfamily Arctiinae. It is found in Japan, China and India.
Agrisius similis | Species of moth | species of insect | Agrisius similis is a moth of the subfamily Arctiinae. It is found in China Yunnan.
Agrisius vernalis | Species of moth | species of insect | Agrisius vernalis is a moth of the subfamily Arctiinae. It is found in China Guangdong.
Agrotera lienpingialis | Species of moth | species of insect | Agrotera lienpingialis is a moth in the family Crambidae. It was described by Aristide Caradja in 1925.
Agylla sinensis | Species of moth | species of insect | Agylla sinensis is a moth of the family Erebidae. It was described by John Henry Leech in 1899.
Agylla vittata | Species of moth | species of insect | Agylla vittata is a moth of the family Erebidae. It was described by John Henry Leech in 1899.
Ahamus altaicola | Species of moth | species of insect | Ahamus altaicola is a species of moth of the family Hepialidae. It is found in China.
Ahamus anomopterus | Species of moth | species of insect | Ahamus anomopterus is a species of moth of the family Hepialidae. It was described by D.R.
Ahamus jianchuanensis | Species of moth | species of insect | Ahamus jianchuanensis is a species of moth of the family Hepialidae.
Ahamus lijiangensis | Species of moth | species of insect | Ahamus lijiangensis is a species of moth of the family Hepialidae.
Ahamus luquensis | Species of moth | species of insect | Ahamus luquensis is a species of moth of the family Hepialidae. It was described by D.R.
Ahamus maquensis | Species of moth | species of insect | Ahamus maquensis is a species of moth of the family Hepialidae. It is found in China.
Ahamus menyuanicus | Species of moth | species of insect | Ahamus menyuanicus is a species of moth of the family Hepialidae.
Ahamus sichuanus | Species of moth | species of insect | Ahamus sichuanus is a species of moth of the family Hepialidae.
Ahamus yulongensis | Species of moth | species of insect | Ahamus yulongensis is a species of moth of the family Hepialidae. It was described by Liang et al.
Ahamus yunlongensis | Species of moth | species of insect | Ahamus yunlongensis is a species of moth of the family Hepialidae.
Ahamus yunnanensis | Species of moth | species of insect | Ahamus yunnanensis is a species of moth of the family Hepialidae. It was described by  D.R. Yang, C.D. Li and C.
Ahamus yushuensis | Species of moth | species of insect | Ahamus yushuensis is a species of moth of the family Hepialidae. It is found in China.
Ahamus zadoiensis | Species of moth | species of insect | Ahamus zadoiensis is a species of moth of the family Hepialidae. It is found in China.
Ahamus zhayuensis | Species of moth | species of insect | Ahamus zhayuensis is a species of moth of the family Hepialidae.
Allotalanta deceptrix | Species of moth | species of insect | Allotalanta deceptrix is a moth in the family Cosmopterigidae. It was described by Edward Meyrick in 1925.
Aloa collaris | Species of moth | species of insect | Aloa collaris is a moth of the family Erebidae. It was described by George Hampson in 1891.
Alphaea anopunctata | Species of moth | species of insect | Alphaea anopunctata is a moth of the family Erebidae. It was described by Charles Oberthr in 1896.
Alphaea chiyo | Species of moth | species of insect | Alphaea chiyo is a moth of the family Erebidae.
Alphaea dellabrunai | Species of moth | species of insect | Alphaea dellabrunai is a moth of the family Erebidae. It was described by Saldaitis and Ivinskis in 2008.
Alphaea hongfena | Species of moth | species of insect | Alphaea hongfena is a moth of the family Erebidae. It was described by Cheng-Lai Fang in 1983.
Alphaea khasiana | Species of moth | species of insect | Alphaea khasiana is a moth of the family Erebidae first described by Walter Rothschild in 1910.
Alphaea turatii | Species of moth | species of insect | Alphaea turatii is a moth of the family Erebidae. It was described by Charles Oberthr in 1911.
Amata perixanthia | Species of moth | species of insect | Amata perixanthia is a moth of the family Erebidae first described by George Hampson in 1898.
Amata polymita | Species of moth | species of insect | Amata polymita, the tiger-striped clearwing moth, is a moth of the family Erebidae.
Ambia naumanni | Species of moth | species of insect | Ambia naumanni is a moth in the family Crambidae. It was described by Wolfgang Speidel and Dieter Stning in 2005.
Ambulyx adhemariusa | Species of moth | species of insect | Ambulyx adhemariusa is a species of moth in the family Sphingidae.
Ambulyx amara | Species of moth | species of insect | Ambulyx amara is a species of moth in the family Sphingidae.
Ambulyx interplacida | Species of moth | species of insect | Ambulyx interplacida is a species of moth of the family Sphingidae first described by Ronald Brechlin in 2006.
Ambulyx pseudoregia | Species of moth | species of insect | Ambulyx pseudoregia is a species of moth of the  family Sphingidae. It is known from China Sichuan.
Ambulyx regia | Species of moth | species of insect | Ambulyx regia is a species of moth of the  family Sphingidae. It is known from China Guangxi.
Ambulyx schauffelbergeri | Species of moth | species of insect | Ambulyx schauffelbergeri is a species of moth of the family Sphingidae first described by Otto Vasilievich Bremer and Wi
Ambulyx zhejiangensis | Species of moth | species of insect | Ambulyx zhejiangensis is a species of moth of the  family Sphingidae. It is known from eastern China.
Ammatucha brevilepigera | Species of moth | species of insect | Ammatucha brevilepigera is a species of snout moth in the genus Ammatucha.
Ammatucha flavipalpa | Species of moth | species of insect | Ammatucha flavipalpa is a species of snout moth in the genus Ammatucha.
Ammatucha longilepigera | Species of moth | species of insect | Ammatucha longilepigera is a species of snout moth in the genus Ammatucha.
Ampelophaga nikolae | Species of moth | species of insect | Ampelophaga nikolae is a moth of the  family Sphingidae. It is known from the Jiangxi-Fujian border in China.
Amphicoecia phasmatica | Species of moth | species of insect | Amphicoecia phasmatica is a species of moth of the  family Tortricidae found in Chinas Yunnan province.
Amphipyra alpherakii | Species of moth | species of insect | Amphipyra alpherakii is a moth in the family Noctuidae. It is found in China.
Amsactoides guangxica | Species of moth | species of insect | Amsactoides guangxica is a moth of the family Erebidae.
Amurrhyparia | Genus of moths | genus of insects | Amurrhyparia is a monotypic tiger moth genus in the family Erebidae erected by Vladimir Viktorovitch Dubatolov in 1985.
Anacampsis anisogramma | Species of moth | species of insect | Anacampsis anisogramma is a moth of the family Gelechiidae. It was described by Edward Meyrick in 1927.
Anameristes doryphora | Species of moth | species of moth | Anameristes doryphora is a species of moth of the family Tortricidae. It is found in China Hainan.
Anania albeoverbascalis | Species of moth | species of insect | Anania albeoverbascalis is a moth in the family Crambidae. It was described by Hiroshi Yamanaka in 1966.
Anania chekiangensis | Species of moth | species of insect | Anania chekiangensis is a moth in the family Crambidae. It was described by Munroe and Mutuura in 1969.
Anania cuspidata | Species of moth | species of insect | Anania cuspidata is a moth in the family Crambidae. It was described by Zhang, Li and Wang in 2002.
Anania delicatalis | Species of moth | species of insect | Anania delicatalis is a moth in the family Crambidae. It was described by South in 1901. It is found in China and Japan.
Anania flavidecoralis | Species of moth | species of insect | Anania flavidecoralis is a moth in the family Crambidae. It was described by Munroe and Mutuura in 1969.
Anania flavimacularis | Species of moth | species of insect | Anania flavimacularis is a moth in the family Crambidae.
Anania fuscobrunnealis | Species of moth | species of insect | Anania fuscobrunnealis is a moth in the family Crambidae. It was described by South in 1901.
Anania luteorubralis | Species of moth | species of insect | Anania luteorubralis is a moth in the family Crambidae. It was described by Aristide Caradja in 1916.
Anania occidentalis | Species of moth | species of insect | Anania occidentalis is a moth in the family Crambidae. It was described by Munroe and Mutuura in 1969.
Anania solaris | Species of moth | species of insect | Anania solaris is a moth in the family Crambidae. It was described by Aristide Caradja in 1938.
Anania subfumalis | Species of moth | species of insect | Anania subfumalis is a moth in the family Crambidae. It was described by Munroe and Mutuura in 1971.
Anania teneralis | Species of moth | species of insect | Anania teneralis is a moth in the family Crambidae. It was described by Aristide Caradja in 1939.
Anania vicinalis | Species of moth | species of insect | Anania vicinalis is a moth in the family Crambidae. It was described by South in 1901. It is found in China.
Anarsia beitunica | Species of moth | species of insect | Anarsia beitunica is a moth in the family Gelechiidae. It was described by Hou-Hun Li and Zhe-Min Zheng in 1997.
Anarsia decora | Species of moth | species of insect | Anarsia decora is a moth in the family Gelechiidae. It was described by Hou-Hun Li and Zhe-Min Zheng in 1997.
Anarsia euphorodes | Species of moth | species of insect | Anarsia euphorodes is a moth of the  family Gelechiidae. It is found in China and Taiwan.The wingspan is about 12 mm.
Anarsia eximia | Species of moth | species of insect | Anarsia eximia is a moth in the family Gelechiidae. It was described by Hou-Hun Li and Zhe-Min Zheng in 1997.
Anarsia largimacularis | Species of moth | species of insect | Anarsia largimacularis is a moth in the family Gelechiidae. It was described by Hou-Hun Li and Zhe-Min Zheng in 1997.
Anarsia magnibimaculata | Species of moth | species of insect | Anarsia magnibimaculata is a moth in the family Gelechiidae. It was described by Hou-Hun Li and Zhe-Min Zheng in 1997.
Anarsia novitricornis | Species of moth | species of insect | Anarsia novitricornis is a moth in the family Gelechiidae. It was described by Hou-Hun Li and Zhe-Min Zheng in 1997.
Anarsia squamerecta | Species of moth | species of insect | Anarsia squamerecta is a moth in the family Gelechiidae. It was described by Hou-Hun Li and Zhe-Min Zheng in 1997.
Anatrachyntis ptilodelta | Species of moth | species of insect | Anatrachyntis ptilodelta is a moth in the family Cosmopterigidae.
Anatrachyntis yunnanea | Species of moth | species of insect | Anatrachyntis yunnanea is a moth in the family Cosmopterigidae.
Ancylolomia aduncella | Species of moth | species of insect | Ancylolomia aduncella is a moth in the family Crambidae. It was described by Wang and Sung in 1981.
Ancylolomia carcinella | Species of moth | species of insect | Ancylolomia carcinella is a moth in the family Crambidae. It was described by Wang and Sung in 1981.
Ancylolomia hamatella | Species of moth | species of insect | Ancylolomia hamatella is a moth in the family Crambidae. It was described by Wang and Sung in 1981.
Ancylolomia likiangella | Species of moth | species of insect | Ancylolomia likiangella is a moth in the family Crambidae. It was described by Stanisaw Beszyski in 1970.
Ancylolomia longicorniella | Species of moth | species of insect | Ancylolomia longicorniella is a moth in the family Crambidae. It was described by Shi-Mei Song and Tie-Mei Chen in 2004.
Ancylolomia rotaxella | Species of moth | species of insect | Ancylolomia rotaxella is a moth in the family Crambidae. It was described by Stanisaw Beszyski in 1965.
Ancylolomia umbonella | Species of moth | species of insect | Ancylolomia umbonella is a moth in the family Crambidae. It was described by Wang and Sung in 1981.
Ancylosis euclastella | Species of moth | species of insect | Ancylosis euclastella is a species of snout moth in the genus Ancylosis. It was described by mile Louis Ragonot in 1887.
Ancylosis griseomixtella | Species of moth | species of insect | Ancylosis griseomixtella is a species of snout moth in the genus Ancylosis.
Anerosoma | Genus of moths | species of insect | Anerosoma is a monotypic snout moth genus described by Rolf-Ulrich Roesler in 1971.
Antheraea pernyi | Species of moth | species of insect | Antheraea pernyi, the Chinese oak tussar moth, Chinese tasar moth or '''temperate tussar moth''', is a large moth in the
Antichlidas trigonia | Species of moth | species of insect | Antichlidas trigonia is a species of moth of the family Tortricidae. It is found in China Henan, Hubei.
Antispila kunyuensis | Species of moth |  | Antispila kunyuensis is a moth of the family Heliozelidae. It is found in China Shandong Peninsula.
Anydrelia plicataria | Species of moth | species of insect | Anydrelia plicataria is a moth in the family Geometridae. It is found in China.
Aphelia albidula | Species of moth | species of insect | Aphelia albidula is a species of moth of the family Tortricidae.
Aphelia cinerarialis | Species of moth | species of insect | Aphelia cinerarialis is a species of moth of the family Tortricidae. It is found in Beijing, China.
Aphelia disjuncta | Species of moth | species of insect | Aphelia disjuncta is a species of moth of the family Tortricidae. It is found in Russia and China.
Aphelia flexiloqua | Species of moth | species of insect | Aphelia flexiloqua is a species of moth of the family Tortricidae. It is found in Yunnan, China.
Aphelia fuscialis | Species of moth | species of insect | Aphelia fuscialis is a species of moth of the family Tortricidae. It is found in Yunnan, China.
Aphelia paleana | Species of moth | species of insect | Aphelia paleana, the timothy tortrix ,  is a moth of the family Tortricidae.
Aphomia lolotialis | Species of moth | species of insect | Aphomia lolotialis is a species of snout moth in the genus Aphomia.
Aphomia melli | Species of moth | species of insect | Aphomia melli is a species of snout moth in the genus Aphomia.
Aphomia pygmealis | Species of moth | species of insect | Aphomia pygmealis is a species of snout moth in the genus Aphomia.
Apogurea | Genus of moths | species of insect | Apogurea is a monotypic moth genus in the subfamily Arctiinae erected by Watson, Fletcher and Nye in 1980.
Aprepodoxa mimocharis | Species of moth | species of insect | Aprepodoxa mimocharis is a species of moth of the family Tortricidae. It is found in Yunnan, China.
Aproaerema brevihamata | Species of moth | species of insect | Aproaerema brevihamata is a moth of the family Gelechiidae. It was described by Hou-Hun Li in 1993.
Aproaerema longihamata | Species of moth | species of insect | Aproaerema longihamata is a moth of the family Gelechiidae. It was described by Hou-Hun Li in 1993.
Archips arcanus | Species of moth | species of insect | Archips arcanus is a species of moth of the family Tortricidae. It is found in Zhejiang, China.
Archips compitalis | Species of moth | species of insect | Archips compitalis is a species of moth of the family Tortricidae. It is found in Zhejiang, China.
Archips crassifolianus | Species of moth | species of insect | Archips crassifolianus is a species of moth of the family Tortricidae. It is found in Gansu, China.
Archips elongatus | Species of moth | species of insect | Archips elongatus is a species of moth of the family Tortricidae. It is found in Shaanxi, China.
Archips enodis | Species of moth | species of insect | Archips enodis is a species of moth of the family Tortricidae. It is found in Zhejiang, China.
Archips eximius | Species of moth | species of insect | Archips eximius is a species of moth of the family Tortricidae. It is found in Yunnan, China.
Archips kellerianus | Species of moth | species of insect | Archips kellerianus is a species of moth of the family Tortricidae. It is found in Yunnan and Sichuan, China.
Archips limatus | Species of moth | species of insect | Archips limatus is a species of moth of the family Tortricidae. It is found in Shanxi, China.
Archips menotoma | Species of moth | species of insect | Archips menotoma is a species of moth of the family Tortricidae. It is found in Yunnan, China.
Archips opiparus | Species of moth | species of insect | Archips opiparus is a species of moth of the family Tortricidae.
Archips pachyvalvus | Species of moth | species of insect | Archips pachyvalvus is a species of moth of the family Tortricidae. It is found in Sichuan, China.
Archips rudy | Species of moth | species of insect | Archips rudy is a species of moth of the family Tortricidae. It is found in Shanxi, China.
Archips spinatus | Species of moth | species of insect | Archips spinatus is a species of moth of the family Tortricidae. It is found in Liaoning, China.
Archips strigopterus | Species of moth | species of insect | Archips strigopterus is a species of moth of the family Tortricidae. It is found in Sichuan, China.
Archips strojny | Species of moth | species of insect | Archips strojny is a species of moth of the family Tortricidae. It is found in Hunan, China.
Archips tharsaleopus | Species of moth | species of insect | Archips tharsaleopus is a species of moth of the family Tortricidae. It is found in Zhejiang and Yunnan, China.
Archischoenobius minumus | Species of moth | species of insect | Archischoenobius minumus is a moth in the family Crambidae.
Archischoenobius nanlingensis | Species of moth | species of insect | Archischoenobius nanlingensis is a moth in the family Crambidae.
Archischoenobius nigrolepis | Species of moth | species of insect | Archischoenobius nigrolepis is a moth in the family Crambidae.
Archischoenobius pallidalis | Species of moth | species of insect | Archischoenobius pallidalis is a moth in the family Crambidae. It was described by South in 1901.
Areas galactina | Species of moth | species of insect | Areas galactina is a moth of the family Erebidae. It was described by Jan van der Hoeven in 1840.
Argyarctia sericeipennis | Species of moth | species of insect | Argyarctia sericeipennis is a moth of the family Erebidae. It was described by Rothschild in 1933.
Arichanna sinica | Species of moth | species of insect | Arichanna sinica is a moth of the family Geometridae. It is found in Taiwan, Bhutan and China.The wingspan is 4456 mm.
Aristebulea principis | Species of moth | species of insect | Aristebulea principis is a moth in the family Crambidae. It was described by Munroe and Mutuura in 1968.
Aroga controvalva | Species of moth | species of insect | Aroga controvalva is a moth of the family Gelechiidae. It is found in China Shaanxi.The wingspan is about 18 mm.
Aroga danfengensis | Species of moth | species of insect | Aroga danfengensis is a moth of the family Gelechiidae. It is found in China Shaanxi.
Asclerobia sinensis | Species of moth | species of insect | Asclerobia sinensis is a species of snout moth in the genus Asclerobia.
Ashibusa aculeata | Species of moth | species of insect | Ashibusa aculeata is a moth of the family Cosmopterigidae. It is found in China.
Ashibusa clavativalvula | Species of moth | species of insect | Ashibusa clavativalvula is a moth of the family Cosmopterigidae. It is found in China.
Ashibusa flavalba | Species of moth | species of insect | Ashibusa flavalba is a moth of the family Cosmopterigidae. It is found in China.
Ashibusa lativalvula | Species of moth | species of insect | Ashibusa lativalvula is a moth of the family Cosmopterigidae. It is found in China.
Ashibusa sinensis | Species of moth | species of insect | Ashibusa sinensis is a moth of the family Cosmopterigidae. It was described Z.W. Zhang and H.H.
Ashibusa subelliptica | Species of moth | species of insect | Ashibusa subelliptica is a moth of the family Cosmopterigidae. It was described Z.W. Zhang and H.H.
Asiapistosia stigma | Species of moth | species of insect | Asiapistosia stigma is a moth of the subfamily Arctiinae first described by Cheng-Lai Fang in 2000.
Asiapistosia subnigra | Species of moth | species of insect | Asiapistosia subnigra is a moth of the subfamily Arctiinae. It was described by John Henry Leech in 1899.
Asota canaraica | Species of moth | species of insect | Asota canaraica is a moth of the family Erebidae first described by Moore in 1878. It is found in India and China.
Asota heliconia | Species of moth | species of insect | Asota heliconia is a moth in the family Erebidae.
Assara exiguella | Species of moth | species of insect | Assara exiguella is a species of snout moth in the genus Assara.
Assara hoeneella | Species of moth | species of insect | Assara hoeneella is a species of snout moth in the genus Assara.
Assara incredibilis | Species of moth | species of insect | Assara incredibilis is a species of snout moth in the genus Assara.
Assara linjiangensis | Species of moth | species of insect | Assara linjiangensis is a species of snout moth in the genus Assara.
Assara tumidula | Species of moth | species of insect | Assara tumidula is a species of snout moth in the genus Assara.
Asthena albidaria | Species of moth | species of insect | Asthena albidaria is a moth in the family Geometridae. It is found in western China.
Asthena plenaria | Species of moth | species of insect | Asthena plenaria is a moth in the family Geometridae. It is found in China.
Asura carnea | Species of moth | species of insect | Asura carnea is a moth of the  family Erebidae. It is found in China.
Asura diluta | Species of moth | species of insect | Asura diluta is a moth of the family Erebidae. It is found in China.
Asura griseata | Species of moth | species of insect | Asura griseata is a moth of the  family Erebidae. It is found in China.
Asura irregularis | Species of moth | species of insect | Asura irregularis is a moth of the  family Erebidae. It is found in China.
Asura likiangensis | Species of moth | species of insect | Asura likiangensis is a moth of the family Erebidae. It is found in China.
Asura megala | Species of moth | species of insect | Asura megala is a moth of the family Erebidae. It is found in China.
Asura modesta | Species of moth | species of insect | Asura modesta is a moth of the family Erebidae. It is found in China.
Asura nigrivena | Species of moth | species of insect | Asura nigrivena is a moth of the family Erebidae. It is found in China.
Asura unipuncta | Species of moth | species of insect | Asura unipuncta is a moth of the family Erebidae. It is found in China.
Asuridoides atuntseica | Species of moth | species of insect | Asuridoides atuntseica is a moth of the subfamily Arctiinae. It was described by Franz Daniel in 1951.
Asuridoides osthelderi | Species of moth | species of insect | Asuridoides osthelderi is a moth of the subfamily Arctiinae. It was described by Franz Daniel in 1951.
Athrips bidilatata | Species of moth | species of insect | Athrips bidilatata is a moth of the family Gelechiidae. It is found in China Gansu.The wingspan is about 11.5 mm.
Athrips gansuensis | Species of moth | species of insect | Athrips gansuensis is a moth of the family Gelechiidae. It is found in China Gansu.The wingspan is about 18 mm.
Athrips huangshana | Species of moth | species of insect | Athrips huangshana is a moth of the family Gelechiidae. It is found in Anhui, China.The wingspan is about 12 mm.
Athrips montana | Species of moth | species of insect | Athrips montana is a moth of the family Gelechiidae. It is found in China Gansu.The wingspan is about 18 mm.
Athrips neimongolica | Species of moth | species of insect | Athrips neimongolica is a moth of the family Gelechiidae. It is found in China Inner Mongolia.The wingspan is 1012 mm.
Athrips nigristriata | Species of moth | species of insect | Athrips nigristriata is a moth of the family Gelechiidae. It is found in China Ningxia.The wingspan is about 12 mm.
Athrips ravida | Species of moth | species of insect | Athrips ravida is a moth of the family Gelechiidae. It is found in China Ningxia.The wingspan is 1518 mm.
Athrips septempunctata | Species of moth | species of insect | Athrips septempunctata is a moth of the family Gelechiidae. It is found in China Gansu.The wingspan is 16.517.5 mm.
Athrips tsaidamica | Species of moth | species of insect | Athrips tsaidamica is a moth of the family Gelechiidae. It is found in China Quinghai, Inner Mongolia.
Athrypsiastis salva | Species of moth | species of insect | Athrypsiastis salva is a moth in the family Xyloryctidae. It was described by Edward Meyrick in 1932.
Athymoris martialis | Species of moth | species of insect | Athymoris martialis is a moth in the family Lecithoceridae. It is found in Taiwan, Korea, southern China, and Japan.
Athymoris paramecola | Species of moth | species of insect | Athymoris paramecola is a moth in the family Lecithoceridae. It is found in China Hainan.
Athymoris phreatosa | Species of moth | species of insect | Athymoris phreatosa is a moth in the family Lecithoceridae. It is found in China Sichuan and Taiwan.
Aurorobotys aurorina | Species of moth | species of insect | Aurorobotys aurorina is a moth in the family Crambidae. It was described by Arthur Gardiner Butler in 1878.
Aurorobotys crassispinalis | Species of moth | species of insect | Aurorobotys crassispinalis is a moth in the family Crambidae. It was described by Munroe and Mutuura in 1971.
Austrapoda beijingensis | Species of moth | species of insect | Austrapoda beijingensis is a species of moth of the family Limacodidae. It is found in China.
Austrapoda seres | Species of moth | species of insect | Austrapoda seres is a species of moth of the family Limacodidae.
Autosticha arcivalvaris | Species of moth | species of insect | Autosticha arcivalvaris is a moth in the family Autostichidae. It was described by S.X. Wang in 2004.
Autosticha bacilliformis | Species of moth | species of insect | Autosticha bacilliformis is a moth in the family Autostichidae. It was described by S.X. Wang in 2004.
Autosticha bilobella | Species of moth | species of insect | Autosticha bilobella is a moth in the family Autostichidae. It was described by Kyu-Tek Park and Chun-Sheng Wu in 2003.
Autosticha chishuiensis | Species of moth | species of insect | Autosticha chishuiensis is a moth in the family Autostichidae. It was described by S.X. Wang in 2004.
Autosticha cipingensis | Species of moth | species of insect | Autosticha cipingensis is a moth in the family Autostichidae. It was described by S.X. Wang in 2004.
Autosticha complexivalvula | Species of moth | species of insect | Autosticha complexivalvula is a moth in the family Autostichidae. It was described by S.X. Wang in 2004.
Autosticha conjugipunctata | Species of moth | species of insect | Autosticha conjugipunctata is a moth in the family Autostichidae. It was described by S.X. Wang in 2004.
Autosticha cuspidata | Species of moth | species of insect | Autosticha cuspidata is a moth in the family Autostichidae. It was described by Kyu-Tek Park and Chun-Sheng Wu in 2003.
Autosticha dayuensis | Species of moth | species of insect | Autosticha dayuensis is a moth in the family Autostichidae. It was described by Kyu-Tek Park and Chun-Sheng Wu in 2003.
Autosticha dimochla | Species of moth | species of insect | Autosticha dimochla is a moth in the family Autostichidae. It was described by Edward Meyrick in 1935.
Autosticha fallaciosa | Species of moth | species of insect | Autosticha fallaciosa is a moth in the family Autostichidae. It was described by S.X. Wang in 2004.
Autosticha flavida | Species of moth | species of insect | Autosticha flavida is a moth in the family Autostichidae. It was described by S.X. Wang in 2004.
Autosticha guangdongensis | Species of moth | species of insect | Autosticha guangdongensis is a moth in the family Autostichidae.
Autosticha guttulata | Species of moth | species of insect | Autosticha guttulata is a moth in the family Autostichidae. It was described by Edward Meyrick in 1925.
Autosticha hainanica | Species of moth | species of insect | Autosticha hainanica is a moth in the family Autostichidae. It was described by Kyu-Tek Park and Chun-Sheng Wu in 2003.
Autosticha heteromalla | Species of moth | species of insect | Autosticha heteromalla is a moth in the family Autostichidae. It was described by S.X. Wang in 2004.
Autosticha leukosa | Species of moth | species of insect | Autosticha leukosa is a moth in the family Autostichidae. It was described by Kyu-Tek Park and Chun-Sheng Wu in 2003.
Autosticha lushanensis | Species of moth | species of insect | Autosticha lushanensis is a moth in the family Autostichidae.
Autosticha maculosa | Species of moth | species of insect | Autosticha maculosa is a moth in the family Autostichidae. It was described by S.X. Wang in 2004.
Autosticha menglunica | Species of moth | species of insect | Autosticha menglunica is a moth in the family Autostichidae. It was described by S.X. Wang in 2004.
Autosticha microphilodema | Species of moth | species of insect | Autosticha microphilodema is a moth in the family Autostichidae. It was described by S.X. Wang in 2004.
Autosticha mirabilis | Species of moth | species of insect | Autosticha mirabilis is a moth in the family Autostichidae. It was described by S.X. Wang in 2004.
Autosticha nanchangensis | Species of moth | species of insect | Autosticha nanchangensis is a moth in the family Autostichidae. It was described by S.X. Wang in 2004.
Autosticha oxyacantha | Species of moth | species of insect | Autosticha oxyacantha is a moth in the family Autostichidae. It was described by S.X. Wang in 2004.
Autosticha pentagona | Species of moth | species of insect | Autosticha pentagona is a moth in the family Autostichidae. It was described by Kyu-Tek Park and Chun-Sheng Wu in 2003.
Autosticha rectipunctata | Species of moth | species of insect | Autosticha rectipunctata is a moth in the family Autostichidae. It was described by S.X. Wang in 2004.
Autosticha shenae | Species of moth | species of insect | Autosticha shenae is a moth in the family Autostichidae. It was described by S.X. Wang in 2004.
Autosticha shexianica | Species of moth | species of insect | Autosticha shexianica is a moth in the family Autostichidae. It was described by S.X. Wang in 2004.
Autosticha sichunica | Species of moth | species of insect | Autosticha sichunica is a moth in the family Autostichidae. It was described by Kyu-Tek Park and Chun-Sheng Wu in 2003.
Autosticha sinica | Species of moth | species of insect | Autosticha sinica is a moth in the family Autostichidae. It was described by Kyu-Tek Park and Chun-Sheng Wu in 2003.
Autosticha squarrosa | Species of moth | species of insect | Autosticha squarrosa is a moth in the family Autostichidae. It was described by S.X. Wang in 2004.
Autosticha tetragonopa | Species of moth | species of insect | Autosticha tetragonopa is a moth in the family Autostichidae. It was described by Edward Meyrick in 1935.
Autosticha tianmushana | Species of moth | species of insect | Autosticha tianmushana is a moth in the family Autostichidae. It was described by S.X. Wang in 2004.
Autosticha triangulimaculella | Species of moth | species of insect | Autosticha triangulimaculella is a moth in the family Autostichidae. It was described by Aristide Caradja in 1928.
Autosticha valvidentata | Species of moth | species of insect | Autosticha valvidentata is a moth in the family Autostichidae. It was described by S.X. Wang in 2004.
Autosticha valvifida | Species of moth | species of insect | Autosticha valvifida is a moth in the family Autostichidae. It was described by S.X. Wang in 2004.
Autosticha wufengensis | Species of moth | species of insect | Autosticha wufengensis is a moth in the family Autostichidae. It was described by S.X. Wang in 2004.
Biston marginata | Species of moth | species of insect | Biston marginata is a moth of the family Geometridae.
Brachmia elaeophanes | Species of moth | species of insect | Brachmia elaeophanes is a moth in the family Gelechiidae. It was described by Edward Meyrick in 1930.
Brachmia monotona | Species of moth | species of insect | Brachmia monotona is a moth in the family Gelechiidae. It was described by Aristide Caradja in 1927.
Brachmia obtrectata | Species of moth | species of insect | Brachmia obtrectata is a moth in the family Gelechiidae. It was described by Edward Meyrick in 1922.
Brachmia philodema | Species of moth | species of insect | Brachmia philodema is a moth in the family Gelechiidae. It was described by Edward Meyrick in 1938.
Brachmia quassata | Species of moth | species of insect | Brachmia quassata is a moth in the family Gelechiidae. It was described by Edward Meyrick in 1930. It is found in China.
Brachmia tepidata | Species of moth | species of insect | Brachmia tepidata is a moth in the family Gelechiidae. It was described by Edward Meyrick in 1922.
Brachodes gressitti | Species of moth | species of insect | Brachodes gressitti is a moth of the family Brachodidae that is  endemic to Chinese province of Hainan.
Brahmaea certhia | Species of moth | species of insect | Brahmaea certhia, the Sino-Korean owl moth,  is a moth from the family Brahmaeidae, the Brahmin moths.
Brahmaea wallichii | Species of moth | species of insect | Brahmaea wallichii, also known as the owl moth, is a moth from the family Brahmaeidae, the Brahmin moths, and one of its
Bryotropha brevivalvata | Species of moth | species of insect | Bryotropha brevivalvata is a moth of the family Gelechiidae. It is found in central China.
Bryotropha elegantula | Species of moth | species of insect | Bryotropha elegantula is a moth of the family Gelechiidae. It is found in Qinghai, China.
Bryotropha montana | Species of moth | species of insect | Bryotropha montana is a moth of the family Gelechiidae. It is found in central China.
Bryotropha palliptera | Species of moth | species of insect | Bryotropha palliptera is a moth of the family Gelechiidae. It is found in Henan, China.
Caligula anna | Species of moth | species of insect | Caligula anna is a moth of the family Saturniidae. It is found in south-eastern and southern Asia, including China.
Caligula japonica | Species of moth | species of insect | Caligula japonica, the Japanese giant silkworm, is a moth of the  family Saturniidae. It was described by Moore in 1872.
Caligula jonasi | Species of moth | species of insect | Caligula jonasi, the jonasi silkmoth, is a moth of the family Saturniidae.
Calleremites | Genus of moths | species of insect | Calleremites is a monotypic moth genus in the family Geometridae.
Callindra equitalis | Species of moth | species of insect | Callindra equitalis is a moth of the family Erebidae. It was described by Vincenz Kollar in 1844.
Callindra principalis | Species of moth | species of insect | Callindra principalis is a moth of the family Erebidae. It was described by Vincenz Kollar in 1844.
Calliteara lunulata | Species of moth | species of moth | Calliteara lunulata is a moth of the family Erebidae. It is found in the Russian Far East, Japan, China and Taiwan.
Callopistria nigrescens | Species of moth | species of insect | Callopistria nigrescens is a moth of the family Noctuidae. It is found in China and Taiwan.
Caloptilia aeolospila | Species of moth | species of insect | Caloptilia aeolospila is a moth of the family Gracillariidae. It is known from China Yunnan.
Caloptilia bimaculata | Species of moth | species of insect | Caloptilia bimaculata is a moth of the family Gracillariidae. It is known from China Sichuan.
Caloptilia dactylifera | Species of moth | species of insect | Caloptilia dactylifera is a moth of the family Gracillariidae. It is known from China Jiangxi.
Caloptilia dentata | Species of moth | species of insect | Caloptilia dentata is a moth of the family Gracillariidae. It is known from China Beijing.
Caloptilia garcinicola | Species of moth | species of insect | Caloptilia garcinicola is a moth of the family Gracillariidae. It is known from China Guangxi.
Caloptilia gladiatrix | Species of moth | species of insect | Caloptilia gladiatrix is a moth of the family Gracillariidae. It is known from China Shanghai.
Caloptilia hamulifera | Species of moth | species of insect | Caloptilia hamulifera is a moth of the family Gracillariidae. It is known from China Sichuan.
Caloptilia hypodroma | Species of moth | species of insect | Caloptilia hypodroma is a moth of the family Gracillariidae. It is known from Fujian, China.
Caloptilia jasminicola | Species of moth | species of insect | Caloptilia jasminicola is a moth of the family Gracillariidae. It is known from Fujian and Guangdong, China.
Caloptilia koelreutericola | Species of moth | species of insect | Caloptilia koelreutericola is a moth of the family Gracillariidae. It is known from Beijing, China.
Caloptilia pekinensis | Species of moth | species of insect | Caloptilia pekinensis is a moth of the family Gracillariidae. It is known from Beijing, China.
Caloptilia quadripunctata | Species of moth | species of insect | Caloptilia quadripunctata is a moth of the family Gracillariidae. It is known from Beijing, China.
Caloptilia sassafrasicola | Species of moth | species of insect | Caloptilia sassafrasicola is a moth of the family Gracillariidae. It is known from Fujian, China.
Caloptilia sichuanensis | Species of moth | species of insect | Caloptilia sichuanensis is a moth of the family Gracillariidae. It is known from Sichuan, China.
Caloptilia soyella | Species of moth | species of insect | Caloptilia soyella is a moth of the family Gracillariidae.
Caloptilia spinulosa | Species of moth | species of insect | Caloptilia spinulosa is a moth of the family Gracillariidae. It is known from Jiangxi, China.
Caloptilia striata | Species of moth | species of insect | Caloptilia striata is a moth of the family Gracillariidae. It is known from Jiangxi, China.
Caloptilia striolata | Species of moth | species of insect | Caloptilia striolata is a moth of the family Gracillariidae. It is known from Fujian, China.
Caloptilia tricolor | Species of moth | species of insect | Caloptilia tricolor is a moth of the family Gracillariidae. It is known from Fujian, China.
Caloptilia trimaculiformis | Species of moth | species of insect | Caloptilia trimaculiformis is a moth of the family Gracillariidae. It is known from Fujian, China.
Calpenia saundersi | Species of moth | species of insect | Calpenia saundersi is a tiger moth in the family Erebidae first described by Frederic Moore in 1872.
Camptoloma bella | Species of moth | species of insect | Camptoloma bella is a moth of the subfamily Arctiinae. It is endemic to Guangxi in China.The wingspan is about 45 mm.
Camptoloma kishidai | Species of moth | species of insect | Camptoloma kishidai is a moth of the subfamily Arctiinae. It is endemic to Guangdong in China.
Caradjaria | Genus of moths | species of insect | Caradjaria is a genus of snout moths. It was described by Roesler, in 1975, and contains the species C. asiatella.
Catephia albomacula | Species of moth | species of insect | Catephia albomacula is a species of moth of the family Erebidae. It is found in China.
Catephia molybdocrosis | Species of moth | species of insect | Catephia molybdocrosis is a species of moth of the  family Erebidae. It is found in southern China.
Catephia stygia | Species of moth | species of insect | Catephia stygia is a species of moth of the  family Erebidae. It is found in western China.
Catocala aestimabilis | Species of moth | species of moth | Catocala aestimabilis is a moth of the family Erebidae. It is found in Xinjiang, China.
Catocala borthi | Species of moth | species of moth | Catocala borthi is a moth in the family Erebidae. It is found in China Sichuan.
Catocala butleri | Species of moth | species of moth | Catocala butleri is a moth of the family Erebidae first described by John Henry Leech in 1900.
Catocala chenyixini | Species of moth | species of moth | Catocala chenyixini is a moth in the family Erebidae. It is found in China Chekiang.
Catocala contemnenda | Species of moth | species of moth | Catocala contemnenda is a moth of the family Erebidae first described by Staudinger in 1891.
Catocala davidi | Species of moth | species of moth | Catocala davidi is a moth in the family Erebidae first described by Oberthr in 1881. It is found in northern China.
Catocala dejeani | Species of moth | species of moth | Catocala dejeani is a moth of the family Erebidae first described by Rudolf Mell in 1936.
Catocala ellamajor | Species of moth | species of moth | Catocala ellamajor is a moth in the family Erebidae. It is found in China Sichuan.
Catocala florianii | Species of moth | species of moth | Catocala florianii is a moth in the family Erebidae. It is found in China Shaanxi.
Catocala gansan | Species of moth | species of moth | Catocala gansan is a moth in the family Erebidae. It is found in China Yunnan.
Catocala haitzi | Species of moth | species of moth | Catocala haitzi is a moth in the family Erebidae first described by Otto Bang-Haas in 1936. It is found in Gansu, China.
Catocala hoenei | Species of moth | species of moth | Catocala hoenei is a moth in the family Erebidae first described by Rudolf Mell in 1936. It is found in Yunnan, China.
Catocala hoferi | Species of moth | species of moth | Catocala hoferi is a moth in the family Erebidae. It is found in China.
Catocala hymenoides | Species of moth | species of moth | Catocala hymenoides is a moth in the family Erebidae first described by Johannes Draeseke in 1927. It is found in China.
Catocala infasciata | Species of moth | species of moth | Catocala infasciata is a moth in the family Erebidae first described by Rudolf Mell in 1936.
Catocala invasa | Species of moth | species of insect | Catocala invasa is a moth of the family Erebidae first described by John Henry Leech in 1900. It is found in China.
Catocala jansseni | Species of moth | species of insect | Catocala jansseni is a moth in the family Erebidae first described by A. E.  Prout in 1924. It is found in China.
Catocala jouga | Species of moth | species of moth | Catocala jouga is a moth in the family Erebidae. It is found in China Yunnan and Vietnam.
Catocala juncta | Species of moth | species of moth | Catocala juncta is a moth of the family Erebidae first described by Staudinger in 1889. It is found in Xinjiang, China.
Catocala jyoka | Species of moth | species of moth | Catocala jyoka is a moth in the family Erebidae. It is found in China in the province of Sichuan.
Catocala kaki | Species of moth | species of moth | Catocala kaki is a moth in the family Erebidae. It is found in China Shaanxi.
Catocala kasenko | Species of moth | species of moth | Catocala kasenko is a moth in the family Erebidae. It is found in China Sichuan.
Catocala largeteaui | Species of moth | species of moth | Catocala largeteaui is a moth in the family Erebidae first described by Charles Oberthr in 1881. It is found in China.
Catocala lehmanni | Species of moth | species of moth | Catocala lehmanni is a moth in the family Erebidae. It is found in China Sichuan.
Catocala longipalpis | Species of moth | species of moth | Catocala longipalpis is a moth in the family Erebidae first described by Rudolf Mell in 1936.
Catocala maculata | Species of moth | species of moth | Catocala maculata is a moth in the family Erebidae first described by Vincent in 1919. It is found in China.
Catocala martyrum | Species of moth | species of moth | Catocala martyrum is a moth in the family Erebidae first described by Charles Oberthr in 1881. It is found in China.
Catocala maso | Species of moth | species of moth | Catocala maso is a moth in the family Erebidae. It is found in China Guangdong.
Catocala naumanni | Species of moth | species of insect | Catocala naumanni is a moth in the family Erebidae first described by Andre Valentinovich Sviridov in 1996.
Catocala ohshimai | Species of moth | species of insect | Catocala ohshimai is a moth in the family Erebidae. It is found in China Shaanxi.
Catocala optima | Species of moth | species of insect | Catocala optima, the Turanga underwing, is a moth of the family Erebidae.
Catocala seibaldi | Species of moth | species of insect | Catocala seibaldi is a moth in the family Erebidae. It is found in China Shaanxi.
Catocala seiohbo | Species of moth | species of insect | Catocala seiohbo is a moth of the family Erebidae first described by Katsumi Ishizuka in 2002.
Catocala sinyaevi | Species of moth | species of insect | Catocala sinyaevi is a moth in the family Erebidae first described by Andre Valentinovich Sviridov in 2004.
Catocala svetlana | Species of moth | species of insect | Catocala svetlana is a moth in the family Erebidae. It is found in China Fujian.
Catocala szechuena | Species of moth | species of insect | Catocala szechuena is a moth of the family Erebidae first described by George Hampson in 1913.
Catocala thomsoni | Species of moth | species of insect | Catocala thomsoni is a moth in the family Erebidae first described by A. E. Prout in 1924.
Catocala triphaenoides | Species of moth | species of insect | Catocala triphaenoides is a moth in the family Erebidae first described by Charles Oberthr in 1881.
Catocala uljanae | Species of moth | species of insect | Catocala uljanae is a moth in the family Erebidae. It is found in China Sichuan.
Catocala xizangensis | Species of moth | species of insect | Catocala xizangensis is a moth in the family Erebidae. It is found in China Xizang.
Catoptria mienshani | Species of moth | species of insect | Catoptria mienshani is a moth in the family Crambidae. It was described by Stanisaw Beszyski in 1965.
Catoptria pandora | Species of moth | species of insect | Catoptria pandora is a moth in the family Crambidae. It was described by Stanisaw Beszyski in 1965.
Catoptria persephone | Species of moth | species of insect | Catoptria persephone is a moth in the family Crambidae. It was described by Stanisaw Beszyski in 1965.
Catoptria thibetica | Species of moth | species of insect | Catoptria thibetica is a moth in the family Crambidae. It was described by Stanisaw Beszyski in 1965.
Catoptria xerxes | Species of moth | species of insect | Catoptria xerxes is a moth in the family Crambidae. It was described by Sauber in 1904. It is found in China Xinjiang.
Cerura menciana | Species of moth | species of moth | Cerura menciana is a moth of the  family Notodontidae. It is found in Japan, Korea, China, Burma and Taiwan.
Chrysoteuchia curvicavus | Species of moth | species of insect | Chrysoteuchia curvicavus is a moth in the family Crambidae. It was described by Shi-Mei Song and Tie-Mei Chen in 2001.
Chrysoteuchia deltella | Species of moth | species of insect | Chrysoteuchia deltella is a moth in the family Crambidae. It was described by Shi-Mei Song and Tie-Mei Chen in 2001.
Chrysoteuchia dentatella | Species of moth | species of insect | Chrysoteuchia dentatella is a moth in the family Crambidae. It was described by Shi-Mei Song and Tie-Mei Chen in 2001.
Chrysoteuchia disasterella | Species of moth | species of insect | Chrysoteuchia disasterella is a moth in the family Crambidae. It was described by Stanisaw Beszyski in 1965.
Chrysoteuchia fractellus | Species of moth | species of insect | Chrysoteuchia fractellus is a moth in the family Crambidae. It was described by South in 1901.
Chrysoteuchia fuliginosellus | Species of moth | species of insect | Chrysoteuchia fuliginosellus is a moth in the family Crambidae. It was described by South in 1901.
Chrysoteuchia funebrellus | Species of moth | species of insect | Chrysoteuchia funebrellus is a moth in the family Crambidae. It was described by Aristide Caradja in 1937.
Chrysoteuchia furva | Species of moth | species of insect | Chrysoteuchia furva is a moth in the family Crambidae. It was described by Hou-Hun Li and Wei-Chun Li in 2010.
Chrysoteuchia hamatella | Species of moth | species of insect | Chrysoteuchia hamatella is a moth in the family Crambidae.
Chrysoteuchia hamatoides | Species of moth | species of insect | Chrysoteuchia hamatoides is a moth in the family Crambidae. It was described by Shi-Mei Song and Tie-Mei Chen in 2001.
Chrysoteuchia hyalodiscella | Species of moth | species of insect | Chrysoteuchia hyalodiscella is a moth in the family Crambidae. It was described by Aristide Caradja in 1927.
Chrysoteuchia lolotiella | Species of moth | species of insect | Chrysoteuchia lolotiella is a moth in the family Crambidae. It was described by Aristide Caradja in 1927.
Chrysoteuchia ningensis | Species of moth | species of insect | Chrysoteuchia ningensis is a moth in the family Crambidae. It was described by Wei-Chun Li in 2012.
Chrysoteuchia nonifasciaria | Species of moth | species of insect | Chrysoteuchia nonifasciaria is a moth in the family Crambidae. It was described by Hou-Hun Li and Wei-Chun Li in 2010.
Chrysoteuchia picturatellus | Species of moth | species of insect | Chrysoteuchia picturatellus is a moth in the family Crambidae. It was described by South in 1901.
Chrysoteuchia quadrapicula | Species of moth | species of insect | Chrysoteuchia quadrapicula is a moth in the family Crambidae.
Chrysoteuchia rotundiprojecta | Species of moth | species of insect | Chrysoteuchia rotundiprojecta is a moth in the family Crambidae. It was described by Hou-Hun Li and Wei-Chun Li in 2010.
Chrysoteuchia shafferi | Species of moth | species of insect | Chrysoteuchia shafferi is a moth in the family Crambidae. It was described by Hou-Hun Li and Wei-Chun Li in 2010.
Chrysoteuchia yuennanellus | Species of moth | species of insect | Chrysoteuchia yuennanellus is a moth in the family Crambidae. It was described by Aristide Caradja in 1937.
Cirrhochrista spinuella | Species of moth | species of insect | Cirrhochrista spinuella is a moth in the family Crambidae.
Cochylidia contumescens | Species of moth | species of insect | Cochylidia contumescens is a species of moth of the family Tortricidae. It was described by Edward Meyrick in 1931.
Cochylidia liui | Species of moth | species of insect | Cochylidia liui is a species of moth of the family Tortricidae. It is found in Guizhou, China.The wingspan is about .
Cochylimorpha alticolana | Species of moth | species of insect | Cochylimorpha alticolana is a species of moth of the family Tortricidae. It is found in Xizang, China.
Cochylimorpha amabilis | Species of moth | species of insect | Cochylimorpha amabilis is a species of moth of the family Tortricidae. It is found in China Xizang and Japan.
Cochylimorpha bipunctata | Species of moth | species of insect | Cochylimorpha bipunctata is a species of moth of the family Tortricidae. It is found in Shanxi, China.
Cochylimorpha conankinensis | Species of moth | species of insect | Cochylimorpha conankinensis is a species of moth of the family Tortricidae.
Cochylimorpha cuspidata | Species of moth | species of insect | Cochylimorpha cuspidata is a species of moth of the family Tortricidae.
Cochylimorpha fuscimacula | Species of moth | species of insect | Cochylimorpha fuscimacula is a species of moth of the family Tortricidae.
Cochylimorpha isocornutana | Species of moth | species of insect | Cochylimorpha isocornutana is a species of moth of the family Tortricidae. It is found in Yunnan, China.
Cochylimorpha jaculana | Species of moth | species of insect | Cochylimorpha jaculana is a species of moth of the family Tortricidae.
Cochylimorpha lungtangensis | Species of moth | species of insect | Cochylimorpha lungtangensis is a species of moth of the family Tortricidae.
Cochylimorpha maleropa | Species of moth | species of insect | Cochylimorpha maleropa is a species of moth of the family Tortricidae. It is found in China Shaanxi, Yunnan.
Cochylimorpha nankinensis | Species of moth | species of insect | Cochylimorpha nankinensis is a species of moth of the family Tortricidae.
Cochylimorpha nipponana | Species of moth | species of insect | Cochylimorpha nipponana is a species of moth of the family Tortricidae.
Cochylimorpha perturbatana | Species of moth | species of insect | Cochylimorpha perturbatana is a species of moth of the family Tortricidae. It is found in China Xinjiang and Russia.
Cochylimorpha razowskiana | Species of moth | species of insect | Cochylimorpha razowskiana is a species of moth of the family Tortricidae.
Cochylimorpha simplicis | Species of moth | species of insect | Cochylimorpha simplicis is a species of moth of the family Tortricidae. It is found in Shanxi, China.
Cochylimorpha yangtseana | Species of moth | species of insect | Cochylimorpha yangtseana is a species of moth of the family Tortricidae. It is found in Xizang, China.
Coleophora alticorollina | Species of moth | species of insect | Coleophora alticorollina is a moth of the family Coleophoridae. It is found in China.
Coleophora apicidentata | Species of moth | species of insect | Coleophora apicidentata is a moth of the family Coleophoridae. It is found in China.
Coleophora buteella | Species of moth | species of insect | Coleophora buteella is a moth of the family Coleophoridae. It is found in Yunnan in southern China.
Coleophora capitargentella | Species of moth | species of insect | Coleophora capitargentella is a moth of the family Coleophoridae. It is mainly found in China.
Coleophora caradjai | Species of moth | species of insect | Coleophora caradjai is a moth of the family Coleophoridae. It is found in Shandong in eastern China.
Coleophora carchara | Species of moth | species of insect | Coleophora carchara is a moth of the family Coleophoridae. It is found in China and Mongolia.
Coleophora cuprea | Species of moth | species of insect | Coleophora cuprea is a moth of the family Coleophoridae. It is found in China.
Coleophora curvidentatella | Species of moth | species of insect | Coleophora curvidentatella is a moth of the family Coleophoridae. It is found in China.
Coleophora dangchuanica | Species of moth | species of insect | Coleophora dangchuanica is a moth of the family Coleophoridae. It is found in Gansu, China.
Coleophora dorsiproducta | Species of moth | species of insect | Coleophora dorsiproducta is a moth of the family Coleophoridae. It is found in China.
Coleophora estriatella | Species of moth | species of insect | Coleophora estriatella is a moth of the family Coleophoridae. It is found in China.The wingspan is about 17.5 mm.
Coleophora eucalla | Species of moth | species of insect | Coleophora eucalla is a moth of the family Coleophoridae. It is found in China.
Coleophora falcipenella | Species of moth | species of insect | Coleophora falcipenella is a moth of the family Coleophoridae. It is found in Yunnan, China.The wingspan is about 15 mm.
Coleophora fengxianica | Species of moth | species of insect | Coleophora fengxianica is a moth of the family Coleophoridae. It is found in Shaanxi, China.
Coleophora gongliuensis | Species of moth | species of insect | Coleophora gongliuensis is a moth of the family Coleophoridae. It is found in Xinjiang, China.
Coleophora harbinensis | Species of moth | species of insect | Coleophora harbinensis is a moth of the family Coleophoridae. It is found in China.
Coleophora heihensis | Species of moth | species of insect | Coleophora heihensis is a moth of the family Coleophoridae. It is found in China.The wingspan is 16.5-17.5 mm.
Coleophora jaculatoria | Species of moth | species of insect | Coleophora jaculatoria is a moth of the family Coleophoridae. It is found in Shaanxi, China.
Coleophora lativalva | Species of moth | species of insect | Coleophora lativalva is a moth of the family Coleophoridae. It is found in China.
Coleophora longispina | Species of moth | species of insect | Coleophora longispina is a moth of the family Coleophoridae. It is found in China.
Coleophora lucida | Species of moth | species of insect | Coleophora lucida is a moth of the family Coleophoridae. It is found in Zhejiang in eastern China.
Coleophora melanograpta | Species of moth | species of insect | Coleophora melanograpta is a moth of the family Coleophoridae.
Coleophora montana | Species of moth | species of insect | Coleophora montana is a moth of the family Coleophoridae. It is found in China.
Coleophora neobagorella | Species of moth | species of insect | Coleophora neobagorella is a moth of the family Coleophoridae. It is found in China.
Coleophora neolycii | Species of moth | species of insect | Coleophora neolycii is a moth of the family Coleophoridae which is endemic to China Ningxia.The wingspan is .
Coleophora ningxiana | Species of moth | species of insect | Coleophora ningxiana is a moth of the family Coleophoridae which is endemic to China Ningxia.The wingspan is about .
Coleophora novisqualorella | Species of moth | species of insect | Coleophora novisqualorella is a moth of the family Coleophoridae. It is found in China.
Coleophora nyingchiensis | Species of moth | species of insect | Coleophora nyingchiensis is a moth of the family Coleophoridae. It is found in China.
Coleophora ochroptera | Species of moth | species of insect | Coleophora ochroptera is a moth of the family Coleophoridae. It is found in Xinjiang, China.
Coleophora orientalis | Species of moth | species of insect | Coleophora orientalis is a moth of the family Coleophoridae. It is found in Wudalianchi, China.
Coleophora ossaedeaga | Species of moth | species of insect | Coleophora ossaedeaga is a moth of the family Coleophoridae. It is found in China.
Coleophora pallidiptera | Species of moth | species of insect | Coleophora pallidiptera is a moth of the family Coleophoridae. It is found in China.
Coleophora pandionella | Species of moth | species of insect | Coleophora pandionella is a moth of the family Coleophoridae. It is found in Russia and China.
Coleophora paradoxella | Species of moth | species of insect | Coleophora paradoxella is a moth of the family Coleophoridae. It is found in southern Russia and China.
Coleophora parilis | Species of moth | species of insect | Coleophora parilis is a moth of the family Coleophoridae. It is found in Inner Mongolia, China.The wingspan is 8.5-13.
Coleophora pendulivalvula | Species of moth | species of insect | Coleophora pendulivalvula is a moth of the family Coleophoridae. It is found in China.
Coleophora plurispinella | Species of moth | species of insect | Coleophora plurispinella is a moth of the family Coleophoridae. It is found in Shandong, eastern China.
Coleophora quadrifurca | Species of moth | species of insect | Coleophora quadrifurca is a moth of the family Coleophoridae. It is found in Shaanxi, China.
Coleophora resupina | Species of moth | species of insect | Coleophora resupina is a moth of the family Coleophoridae. It is found in China.
Coleophora sittella | Species of moth | species of insect | Coleophora sittella is a moth of the family Coleophoridae. It is found in south-western and eastern China.
Coleophora summivola | Species of moth | species of insect | Coleophora summivola is a moth of the family Coleophoridae. It is found in China.
Coleophora symmicta | Species of moth | species of insect | Coleophora symmicta is a moth of the family Coleophoridae. It is found in China.
Coleophora varisequens | Species of moth | species of insect | Coleophora varisequens is a moth of the family Coleophoridae. It is found in Inner Mongolia, China.
Coleophora weymarni | Species of moth | species of insect | Coleophora weymarni is a moth of the family Coleophoridae. It is found in China Manchuria.
Coleophora xinjiangensis | Species of moth | species of insect | Coleophora xinjiangensis is a moth of the family Coleophoridae. It is found in China.The wingspan is 1114 mm.
Coleophora yunnanica | Species of moth | species of insect | Coleophora yunnanica is a moth of the family Coleophoridae. It is found in Yunnan, China.The wingspan is 1213 mm.
Coleophora yuzhongensis | Species of moth | species of insect | Coleophora yuzhongensis is a moth of the family Coleophoridae. It is found in Gansu, China.
Compsoctena pinguis | Species of moth | species of insect | Compsoctena pinguis is a moth in the family Eriocottidae. It was described by Edward Meyrick in 1914.
Concubina | Genus of moths | genus of insects | Concubina is a genus of moths in the family Gelechiidae.
Cossus hoenei | Species of moth | species of insect | Cossus hoenei is a moth in the family Cossidae. It is found in China Shaanxi.The length of the forewings is about 22 mm.
Cotachena pubescens | Species of moth | species of insect | Cotachena pubescens is a moth in the family Crambidae. It was described by Warren in 1892.
Crambus achilles | Species of moth | species of insect | Crambus achilles is a moth in the family Crambidae. It was described by Stanisaw Beszyski in 1961.
Crambus bipartellus | Species of moth | species of insect | Crambus bipartellus is a moth in the family Crambidae. It was described by South in 1901. It is found in China Sichuan.
Crambus isshiki | Species of moth | species of insect | Crambus isshiki is a moth in the family Crambidae. It was described by Shnen Matsumura in 1925.
Crambus magnificus | Species of moth | species of insect | Crambus magnificus is a moth in the family Crambidae. It was described by Stanisaw Beszyski in 1956.
Crambus narcissus | Species of moth | species of insect | Crambus narcissus is a moth in the family Crambidae. It was described by Stanisaw Beszyski in 1961.
Crambus nigriscriptellus | Species of moth | species of insect | Crambus nigriscriptellus is a moth in the family Crambidae. It was described by South in 1901.
Crambus sinicolellus | Species of moth | species of insect | Crambus sinicolellus is a moth in the family Crambidae. It was described by Aristide Caradja in 1926.
Cyclophora mesotoma | Species of moth | species of insect | Cyclophora mesotoma is a moth in the  family Geometridae. It is found in China Hainan.
Deltoplastis prionaspis | Species of moth | species of insect | Deltoplastis prionaspis is a moth in the family Lecithoceridae. It was described by Lszl Anthony Gozmny in 1978.
Dichagyris juldussi | Species of moth | species of insect | Dichagyris juldussi is a moth of the family Noctuidae. It is found in western China, western Tibet and Turkestan.
Doloploca supina | Species of moth | species of insect | Doloploca supina is a species of moth of the family Tortricidae. It is found in China Jiangsu.
Drasteria scolopax | Species of moth | species of insect | Drasteria scolopax is a moth of the family Erebidae. It is found in China Tibet, Qinghai, Gansu and Russia Siberia.
Eboda dissimilis | Species of moth | species of insect | Eboda dissimilis is a species of moth of the family Tortricidae. It is found in China Yunnan.
Ectomyelois bipectinalis | Species of moth | species of insect | Ectomyelois bipectinalis is a species of snout moth. It is found in China Fujian, Gansu, Guangxi, Hainan, Yunnan]]).
Ectomyelois furvivena | Species of moth | species of insect | Ectomyelois furvivena is a species of snout moth. It is found in China Gansu, Yunnan.The wingspan is 2530 mm.
Elophila nigrolinealis | Species of moth | species of insect | Elophila nigrolinealis is a moth in the family Crambidae. It was described by Pryer in 1877.
Elophila nuda | Species of moth | species of insect | Elophila nuda is a moth in the family Crambidae.
Elophila radiospinula | Species of moth | species of insect | Elophila radiospinula is a moth in the family Crambidae.
Elophila roesleri | Species of moth | species of insect | Elophila roesleri is a moth in the family Crambidae. It was described by Speidel in 1984. It is found in China Yunnan.
Elusa inventa | Species of moth | species of insect | Elusa inventa is a species of moth of the family Noctuidae.
Epermenia dalianicola | Species of moth | species of insect | Epermenia dalianicola is a moth in the family Epermeniidae. It was described by Reinhard Gaedike in 2007.
Epermenia sinica | Species of moth | species of insect | Epermenia sinica is a moth in the family Epermeniidae. It was described by Reinhard Gaedike in 1996.
Epicephala angustisaccula | Species of moth | species of insect | Epicephala angustisaccula is a moth of the family Gracillariidae. It is found in China Hainan.
Epicephala domina | Species of moth | species of insect | Epicephala domina is a moth of the family Gracillariidae. It is found in China Hainan.The length of the forewings is 7.
Epicephala impolliniferens | Species of moth | species of insect | Epicephala impolliniferens is a moth of the family Gracillariidae. It is found in China Hainan.
Epicephala lanceolaria | Species of moth | species of insect | Epicephala lanceolaria is a leafflower moth of the family Gracillariidae.
Epicrocis oegnusalis | Species of moth | species of insect | Epicrocis oegnusalis is a species of moth of the  family Pyralidae.
Epinotia solandriana | Species of moth | species of insect | Epinotia solandriana is a moth of the family Tortricidae.
Eschata quadrispinea | Species of moth | species of insect | Eschata quadrispinea is a moth in the family Crambidae. It was described by Wei-Chun Li in 2012.
Euchromius nivalis | Species of moth | species of insect | Euchromius nivalis is a moth in the family Crambidae. It was described by Aristide Caradja in 1937.
Eudocima phalonia | Species of moth | species of moth | Eudocima phalonia, the common fruit-piercing moth, is a fruit piercing moth of the family Erebidae.
Eupithecia amicula | Species of moth | species of insect | Eupithecia amicula is a moth in the family Geometridae first described by Vladimir G.
Eupithecia atrisignis | Species of moth | species of insect | Eupithecia atrisignis is a moth in the  family Geometridae.
Eupithecia chingana | Species of moth | species of moth | Eupithecia chingana is a moth in the family Geometridae. It is found in China.
Eupithecia cichisa | Species of moth | species of insect | Eupithecia cichisa is a moth in the family Geometridae first described by Louis Beethoven Prout in 1939.
Eupithecia egena | Species of moth | species of insect | Eupithecia egena is a moth in the family Geometridae. It is found in China.
Eupithecia epileptica | Species of moth | species of insect | Eupithecia epileptica is a moth in the family Geometridae first described by Andrs Mtys Vojnits in 1984.
Eupithecia eszterkae | Species of moth | species of insect | Eupithecia eszterkae is a moth in the family Geometridae first described by Andrs Mtys Vojnits in 1976.
Eupithecia fervida | Species of moth | species of insect | Eupithecia fervida is a moth in the family Geometridae first described by Andrs Mtys Vojnits in 1984.
Eupithecia fragmentaria | Species of moth | species of insect | Eupithecia fragmentaria is a moth in the family Geometridae first described by Andrs Mtys Vojnits in 1984.
Eupithecia incorrupta | Species of moth | species of insect | Eupithecia incorrupta is a moth in the family Geometridae first described by Andrs Mtys Vojnits in 1984.
Eupithecia inexhausta | Species of moth | species of insect | Eupithecia inexhausta is a moth in the family Geometridae first described by Andrs Mtys Vojnits in 1984.
Eupithecia infortunata | Species of moth | species of insect | Eupithecia infortunata is a moth in the family Geometridae first described by Andrs Mtys Vojnits in 1984.
Eupithecia insana | Species of moth | species of insect | Eupithecia insana is a moth in the family Geometridae first described by Andrs Mtys Vojnits in 1984.
Eupithecia mentita | Species of moth | species of insect | Eupithecia mentita is a moth in the family Geometridae first described by Andrs Mtys Vojnits in 1984.
Eupithecia mortua | Species of moth | species of insect | Eupithecia mortua is a moth in the family Geometridae first described by Andrs Mtys Vojnits in 1984.
Eupithecia omniparens | Species of moth | species of insect | Eupithecia omniparens is a moth in the family Geometridae first described by Karl Dietze in 1908. It is found in China.
Eupithecia paupera | Species of moth | species of insect | Eupithecia paupera is a moth in the family Geometridae. It is found in China.
Eupithecia pekingiana | Species of moth | species of insect | Eupithecia pekingiana is a moth in the family Geometridae. It is found in China.
Eupithecia perendina | Species of moth | species of insect | Eupithecia perendina is a moth in the family Geometridae. It is found in China Yunnan.
Eupithecia perpetua | Species of moth | species of insect | Eupithecia perpetua is a moth in the family Geometridae first described by Andrs Mtys Vojnits in 1984.
Eupithecia placida | Species of moth | species of insect | Eupithecia placida is a moth in the family Geometridae. It is found in China.
Eupithecia pollens | Species of moth | species of insect | Eupithecia pollens is a moth in the family Geometridae. It is found in China.
Eupithecia praecipitata | Species of moth | species of insect | Eupithecia praecipitata is a moth in the family Geometridae. It is found in China.
Eupithecia primitiva | Species of moth | species of insect | Eupithecia primitiva is a moth in the family Geometridae. It is found in western China Gansu.
Eupithecia refertissima | Species of moth | species of insect | Eupithecia refertissima is a moth in the family Geometridae first described by Andrs Mtys Vojnits in 1984.
Eupithecia seminuda | Species of moth | species of insect | Eupithecia seminuda is a moth in the family Geometridae first described by Andrs Mtys Vojnits in 1984.
Eupithecia sempiterna | Species of moth | species of insect | Eupithecia sempiterna is a moth in the family Geometridae. It is found in China.
Eupithecia subbrunneata | Species of moth | species of insect | Eupithecia subbrunneata is a moth in the family Geometridae.
Eupithecia tempestuosa | Species of moth | species of insect | Eupithecia tempestuosa is a moth in the family Geometridae first described by Andrs Mtys Vojnits in 1984.
Eupithecia verprota | Species of moth | species of insect | Eupithecia verprota is a moth in the family Geometridae. It is endemic to central China Shaanxi.The wingspan is about .
Euzophera albipunctella | Species of moth | species of insect | Euzophera albipunctella is a species of snout moth in the genus Euzophera.
Euzophera alpherakyella | Species of moth | species of insect | Euzophera alpherakyella is a species of snout moth in the genus Euzophera. It was described by Ragonot in 1887.
Euzophera atuntsealis | Species of moth | species of insect | Euzophera atuntsealis is a species of snout moth in the genus Euzophera.
Euzophera batangensis | Species of moth | species of insect | Euzophera batangensis is a species of snout moth in the genus Euzophera.
Euzophera cornutella | Species of moth | species of insect | Euzophera cornutella is a species of snout moth in the genus Euzophera.
Euzophera mienshani | Species of moth | species of insect | Euzophera mienshani is a species of snout moth in the genus Euzophera.
Evergestis albifasciaria | Species of moth | species of insect | Evergestis albifasciaria is a moth in the family Crambidae. It was described by Na Chen and Shuxia Wang in 2013.
Evergestis holophaealis | Species of moth | species of insect | Evergestis holophaealis is a moth in the family Crambidae. It was described by George Hampson in 1913.
Exaeretia bignatha | Species of moth | species of insect | Exaeretia bignatha is a moth in the family Depressariidae. It was described by Shu-Xia Wang and Zhe-Min Zheng in 1998.
Exaeretia concaviuscula | Species of moth | species of insect | Exaeretia concaviuscula is a moth in the family Depressariidae. It was described by S.X. Wang in 2005.
Exaeretia crassispina | Species of moth | species of insect | Exaeretia crassispina is a moth in the family Depressariidae. It was described by S.X. Wang in 2005.
Exaeretia deltata | Species of moth | species of insect | Exaeretia deltata is a moth in the family Depressariidae. It was described by S.X. Wang in 2005.
Exaeretia exornata | Species of moth | species of insect | Exaeretia exornata is a moth in the family Depressariidae. It was described by Shu-Xia Wang and Zhe-Min Zheng in 1998.
Exaeretia liupanshana | Species of moth | species of insect | Exaeretia liupanshana is a moth in the family Depressariidae. It is found in China Ningxia.
Exaeretia longifolia | Species of moth | species of insect | Exaeretia longifolia is a moth in the family Depressariidae. It was described by S.X. Wang in 2005.
Exaeretia magnignatha | Species of moth | species of insect | Exaeretia magnignatha is a moth in the family Depressariidae.
Exaeretia qinghaiana | Species of moth | species of insect | Exaeretia qinghaiana is a moth in the family Depressariidae. It was described by S.X. Wang and Z. Zheng in 1996.
Fascellina chromataria | Species of moth | species of insect | Fascellina chromataria is a moth in the family Geometridae described by Francis Walker in 1860.
Ganisa plana | Species of moth | species of insect | Ganisa plana is a moth in the family Eupterotidae. It was described by Francis Walker in 1855.
Gargela albidusa | Species of moth | species of insect | Gargela albidusa is a moth in the family Crambidae.
Gargela bilineata | Species of moth | species of insect | Gargela bilineata is a moth in the family Crambidae.
Gargela distigma | Species of moth | species of insect | Gargela distigma is a moth in the family Crambidae.
Gargela furca | Species of moth | species of insect | Gargela furca is a moth in the family Crambidae.
Gargela fuscusa | Species of moth | species of insect | Gargela fuscusa is a moth in the family Crambidae.
Gargela hainana | Species of moth | species of insect | Gargela hainana is a moth in the family Crambidae.
Gargela hastatela | Species of moth | species of insect | Gargela hastatela is a moth in the family Crambidae.
Gargela quadrispinula | Species of moth | species of insect | Gargela quadrispinula is a moth in the family Crambidae.
Gargela xizangensis | Species of moth | species of insect | Gargela xizangensis is a moth in the family Crambidae.
Gibbovalva clavata | Species of moth | species of insect | Gibbovalva clavata is a moth of the family Gracillariidae. It is found in China Jiangxi.The wingspan is about 7 mm.
Glyphipterix amseli | Species of moth | species of insect | Glyphipterix amseli is a species of sedge moth in the genus Glyphipterix. It was described by Alexey Diakonoff, 1978.
Glyphipterix chionosoma | Species of moth | species of insect | Glyphipterix chionosoma is a species of sedge moth in the genus Glyphipterix.
Glyphipterix deliciosa | Species of moth | species of insect | Glyphipterix deliciosa is a species of sedge moth in the genus Glyphipterix.
Glyphipterix dolichophyes | Species of moth | species of insect | Glyphipterix dolichophyes is a species of sedge moth in the genus Glyphipterix.
Glyphipterix dolichophyses | Species of moth | species of insect | Glyphipterix dolichophyses is a species of sedge moth in the genus Glyphipterix.
Glyphipterix erebanassa | Species of moth | species of insect | Glyphipterix erebanassa is a species of sedge moth in the genus Glyphipterix.
Glyphipterix macrodrachma | Species of moth | species of insect | Glyphipterix macrodrachma is a species of sedge moth in the genus Glyphipterix.
Glyphipterix octatoma | Species of moth | species of insect | Glyphipterix octatoma is a species of sedge moth in the genus Glyphipterix.
Glyphipterix rhinoceropa | Species of moth | species of insect | Glyphipterix rhinoceropa is a species of sedge moth in the genus Glyphipterix.
Glyphipterix semiflavana | Species of moth | species of insect | Glyphipterix semiflavana is a species of sedge moth in the genus Glyphipterix. It was described by Syuti Issiki in 1930.
Glyphodes pulverulentalis | Species of moth | species of insect | Glyphodes pulverulentalis is a moth of the family Crambidae. It was first described by George Hampson in 1896.
Gnorismoneura serrata | Species of moth | species of insect | Gnorismoneura serrata is a moth of the family Tortricidae. It is found in China.The wingspan is 14-16.
Gnorismoneura zetessima | Species of moth | species of insect | Gnorismoneura zetessima is a moth of the family Tortricidae. It is found in China.The wingspan is 18.521 mm for females.
Gymnasura semilutea | Species of moth | species of insect | Gymnasura semilutea is a moth in the subfamily Arctiinae. It is found in Taiwan and China.The wingspan is 1520 mm.
Helcystogramma albilepidotum | Species of moth | species of insect | Helcystogramma albilepidotum is a moth in the family Gelechiidae. It was described by Hou-Hun Li and Hui Zhen in 2011.
Helcystogramma angustum | Species of moth | species of insect | Helcystogramma angustum is a moth in the family Gelechiidae. It was described by Hou-Hun Li and Hui Zhen in 2011.
Helcystogramma bicuneum | Species of moth | species of insect | Helcystogramma bicuneum is a moth in the family Gelechiidae. It was described by Edward Meyrick in 1911.
Helcystogramma brevinodium | Species of moth | species of insect | Helcystogramma brevinodium is a moth in the family Gelechiidae. It was described by Hou-Hun Li and Hui Zhen in 2011.
Helcystogramma ceriochrantum | Species of moth | species of insect | Helcystogramma ceriochrantum is a moth in the family Gelechiidae. It is found in Sichuan, China.
Helcystogramma flavifuscum | Species of moth | species of insect | Helcystogramma flavifuscum is a moth in the family Gelechiidae. It was described by Hou-Hun Li and Hui Zhen in 2011.
Helcystogramma flavistictum | Species of moth | species of insect | Helcystogramma flavistictum is a moth in the family Gelechiidae. It was described by Hou-Hun Li and Hui Zhen in 2011.
Helcystogramma furvimaculare | Species of moth | species of insect | Helcystogramma furvimaculare is a moth in the family Gelechiidae. It was described by Hou-Hun Li and Hui Zhen in 2011.
Helcystogramma hassenzanensis | Species of moth | species of insect | Helcystogramma hassenzanensis is a moth in the family Gelechiidae. It was described by Kyu-Tek Park and Ronald W.
Helcystogramma imagibicuneum | Species of moth | species of insect | Helcystogramma imagibicuneum is a moth in the family Gelechiidae. It was described by Hou-Hun Li and Hui Zhen in 2011.
Helcystogramma imagitrijunctum | Species of moth | species of insect | Helcystogramma imagitrijunctum is a moth in the family Gelechiidae. It was described by Hou-Hun Li and Hui Zhen in 2011.
Helcystogramma rectangulum | Species of moth | species of insect | Helcystogramma rectangulum is a moth in the family Gelechiidae. It was described by Hou-Hun Li and Hui Zhen in 2011.
Helcystogramma trijunctum | Species of moth | species of insect | Helcystogramma trijunctum is a moth in the family Gelechiidae.
Hellinsia sichuana | Species of moth | species of insect | Hellinsia sichuana is a moth of the family Pterophoridae. It is found in south-western China Sichuan.
Hepialiscus nepalensis | Species of moth | species of insect | Hepialiscus nepalensis is a moth of the family Hepialidae. It is found in Nepal, India and China Xizang.
Hepialus xiaojinensis | Species of moth | species of insect | Hepialus xiaojinensis is a species of moth of the family Hepialidae. It is found in Sichuan, China.The wingspan is .
Herochroma cristata | Species of moth | species of insect | Herochroma cristata is a species of moth of the family Geometridae first described by William Warren in 1905.
Herochroma curvata | Species of moth | species of insect | Herochroma curvata is a species of moth of the family Geometridae first described by Hong-Xiang Han and Da-Yong Xue in 2
Herochroma mansfieldi | Species of moth | species of insect | Herochroma mansfieldi is a moth of the family Geometridae first described by Louis Beethoven Prout in 1939.
Herochroma pallensia | Species of moth | species of insect | Herochroma pallensia is a species of moth of the family Geometridae first described by Hongxiang Han and Dayong Xue Dayo
Herochroma perspicillata | Species of moth | species of insect | Herochroma perspicillata is a species of moth of the family Geometridae first described by Hongxiang Han and Dayong Xue
Herochroma rosulata | Species of moth | species of insect | Herochroma rosulata is a species of moth of the family Geometridae first described by Hongxiang Han and Dayong Xue in 20
Herochroma sinapiaria | Species of moth | species of insect | Herochroma sinapiaria is a species of moth of the family Geometridae first described by Gustave Arthur Poujade in 1895.
Herochroma supraviridaria | Species of moth | species of insect | Herochroma supraviridaria is a species of moth of the family Geometridae first described by Hiroshi Inoue in 1999.
Herpetogramma pseudomagna | Species of moth | species of insect | Herpetogramma pseudomagna is a moth in the family Crambidae. It was described by Hiroshi Yamanaka in 1976.
Herpetogramma rudis | Species of moth | species of insect | Herpetogramma rudis is a moth in the family Crambidae. It was described by Warren in 1892.
Homaloxestis aciformis | Species of moth | species of insect | Homaloxestis aciformis is a moth in the family Lecithoceridae.
Homaloxestis eccentropa | Species of moth | species of insect | Homaloxestis eccentropa is a moth in the family Lecithoceridae. It was described by Edward Meyrick in 1934.
Homaloxestis ellipsoidea | Species of moth | species of insect | Homaloxestis ellipsoidea is a moth in the family Lecithoceridae.
Homaloxestis hesperis | Species of moth | species of insect | Homaloxestis hesperis is a moth in the family Lecithoceridae. It was described by Lszl Anthony Gozmny in 1978.
Homaloxestis liochlaena | Species of moth | species of insect | Homaloxestis liochlaena is a moth in the family Lecithoceridae. It was described by Edward Meyrick in 1931.
Homaloxestis mucroraphis | Species of moth | species of insect | Homaloxestis mucroraphis is a moth in the family Lecithoceridae. It was described by Lszl Anthony Gozmny in 1978.
Hydrelia aggerata | Species of moth | species of insect | Hydrelia aggerata is a moth in the family Geometridae. It is found in China.
Hydrelia bella | Species of moth | species of insect | Hydrelia bella is a moth in the family Geometridae first described by Alfred Ernest Wileman in 1916.
Hydrelia castaria | Species of moth | species of insect | Hydrelia castaria is a moth in the family Geometridae first described by John Henry Leech in 1897. It is found in China.
Hydrelia cingulata | Species of moth | species of insect | Hydrelia cingulata is a moth in the family Geometridae first described by George Hampson in 1896. It is found in China.
Hydrelia conspicuaria | Species of moth | species of insect | Hydrelia conspicuaria is a moth in the family Geometridae first described by John Henry Leech in 1897.
Hydrelia crocearia | Species of moth | species of insect | Hydrelia crocearia is a moth in the family Geometridae first described by George Hampson in 1896. It is found in China.
Hydrelia flammulata | Species of moth | species of insect | Hydrelia flammulata is a moth in the family Geometridae first described by Max Bastelberger in 1911.
Hydrelia flavilinea | Species of moth | species of insect | Hydrelia flavilinea is a moth in the family Geometridae first described by William Warren in 1893.
Hydrelia impleta | Species of moth | species of insect | Hydrelia impleta is a moth in the family Geometridae first described by Louis Beethoven Prout in 1938.
Hydrelia laetivirga | Species of moth | species of insect | Hydrelia laetivirga is a moth in the family Geometridae first described by Louis Beethoven Prout in 1934.
Hydrelia latsaria | Species of moth | species of insect | Hydrelia latsaria is a moth in the family Geometridae first described by Charles Oberthr in 1893. It is found in China.
Hydrelia leucogramma | Species of moth | species of insect | Hydrelia leucogramma is a moth in the family Geometridae first described by Wehrli in 1931. It is found in China.
Hydrelia luteosparsata | Species of moth | species of insect | Hydrelia luteosparsata is a moth in the family Geometridae first described by Sterneck in 1928. It is found in China.
Hydrelia ochrearia | Species of moth | species of insect | Hydrelia ochrearia is a moth in the family Geometridae first described by John Henry Leech in 1897.
Hydrelia pavonica | Species of moth | species of insect | Hydrelia pavonica is a moth in the family Geometridae first described by Dayong Xue in 1999. It is found in China.
Hydrelia rhodoptera | Species of moth | species of insect | Hydrelia rhodoptera is a moth in the family Geometridae first described by George Hampson in 1895.
Hydrelia rubraria | Species of moth | species | Hydrelia rubraria is a moth in the family Geometridae first described by George Hampson in 1903.
Hydrelia rufigrisea | Species of moth | species of insect | Hydrelia rufigrisea is a moth in the family Geometridae first described by William Warren in 1893.
Hydrelia rufinota | Species of moth | species of insect | Hydrelia rufinota is a moth in the family Geometridae first described by George Hampson in 1896.
Hydrelia sanguiflua | Species of moth | species of insect | Hydrelia sanguiflua is a moth in the family Geometridae first described by George Hampson in 1896. It is found in China.
Hydrelia sublatsaria | Species of moth | species of insect | Hydrelia sublatsaria is a moth in the family Geometridae first described by Wehrli in 1938. It is found in China.
Hypersypnoides submarginata | Species of moth | species of insect | Hypersypnoides submarginata is a species of moth of the family Noctuidae described by Francis Walker in 1865.
Hypeugoa | Genus of moths | genus of insects | Hypeugoa is a monotypic moth genus in the subfamily Arctiinae.
Hyposidra aquilaria | Species of moth | species of insect | Hyposidra aquilaria is a geometer moth in the Ennominae subfamily.
Hyposidra infixaria | Species of moth | species of insect | Hyposidra infixaria is a geometer moth in the Ennominae subfamily.
Imma caelestis | Species of moth | species of insect | Imma caelestis is a moth in the family Immidae. It was described by Edward Meyrick in 1906.
Imma torophracta | Species of moth | species of insect | Imma torophracta is a moth in the family Immidae. It was described by Edward Meyrick in 1935.
Isodemis proxima | Species of moth | species of insect | Isodemis proxima is a moth of the  family Tortricidae.
Issikiopteryx aurolaxa | Species of moth | species of insect | Issikiopteryx aurolaxa is a moth in the family Lecithoceridae. It is found in China Sichuan.
Issikiopteryx corona | Species of moth | species of insect | Issikiopteryx corona is a moth in the family Lecithoceridae. It is found in China Fujian.
Issikiopteryx fornicata | Species of moth | species of insect | Issikiopteryx fornicata is a moth in the family Lecithoceridae. It is found in China Fujian.
Issikiopteryx nigeriflava | Species of moth | species of insect | Issikiopteryx nigeriflava is a moth in the family Lecithoceridae. It is found in China Tibet.
Issikiopteryx obtusanglua | Species of moth | species of insect | Issikiopteryx obtusanglua is a moth in the family Lecithoceridae. It is found in China Guizhou.
Issikiopteryx ophrysa | Species of moth | species of insect | Issikiopteryx aurolaxa is a moth in the family Lecithoceridae. It is found in China Fujian.
Issikiopteryx parelongata | Species of moth | species of insect | Issikiopteryx parelongata is a moth in the family Lecithoceridae. It is found in China Zhejiang.
Issikiopteryx rotundiconcava | Species of moth | species of insect | Issikiopteryx rotundiconcava is a moth in the family Lecithoceridae. It is found in China Sichuan.
Issikiopteryx suiyangensis | Species of moth | species of insect | Issikiopteryx suiyangensis is a moth in the family Lecithoceridae. It is found in China Guizhou.
Issikiopteryx trichacera | Species of moth | species of insect | Issikiopteryx trichacera is a moth in the family Lecithoceridae. It is found in China.
Issikiopteryx valvispinata | Species of moth | species of insect | Issikiopteryx valvispinata is a moth in the family Lecithoceridae. It is found in China Guizhou.
Issikiopteryx zonophaera | Species of moth | species of insect | Issikiopteryx zonophaera is a moth in the family Lecithoceridae. It is found in Taiwan and eastern Zhejiang, China.
Juxtarctia multiguttata | Species of moth | species of moth | Juxtarctia multiguttata is a polymorphic tiger-moth in the subfamily Arctiinae, endemic for Himalayas.
Kalocyrma decurtata | Species of moth | species of insect | Kalocyrma decurtata is a moth in the family Lecithoceridae. It was described by Chun-Sheng Wu in 1994.
Kalocyrma echita | Species of moth |  | Kalocyrma echita is a moth in the family Lecithoceridae. It was described by Chun-Sheng Wu in 1994.
Krananda lucidaria | Species of moth | species of insect | Krananda lucidaria is a geometer moth in the subfamily Ennominae first described by John Henry Leech in 1897.
Labdia citracma | Species of moth | species of insect | Labdia citracma is a moth of the family Cosmopterigidae. It is found in Taiwan, Japan, India and China.
Lamacha | Genus of moths | species of insect | Lamacha is a monotypic genus of snout moths.
Lamida obscura | Species of moth | species of insect | Lamida obscura is a species of snout moth in the genus Lamida.
Lamprosema hoenei | Species of moth | species of insect | Lamprosema hoenei is a moth in the family Crambidae. It was described by Aristide Caradja in 1932. It is found in China.
Lamprosema pectinalis | Species of moth | species of insect | Lamprosema pectinalis is a moth in the family Crambidae. It was described by George Hampson in 1918.
Lamprosema tienmushanus | Species of moth | species of insect | Lamprosema tienmushanus is a moth in the family Crambidae.
Leechia | Genus of moths | genus of insects | Leechia is a genus of moths of the family Crambidae.
Limnaecia compsasis | Species of moth | species of insect | Limnaecia compsasis is a moth in the family Cosmopterigidae. It is found in China.
Lithosia taishanica | Species of moth | species of insect | Lithosia taishanica is a moth of the family Erebidae. It was described by Franz Daniel in 1954.
Lithosia yuennanensis | Species of moth | species of insect | Lithosia yuennanensis is a moth of the family Erebidae. It was described by Franz Daniel in 1952.
Lomographa guttalata | Species of moth | species of insect | Lomographa guttalata is a moth in the family Geometridae first described by Katsumi Yazaki in 1994.
Lomographa lungtanensis | Species of moth | species of insect | Lomographa lungtanensis is a moth in the family Geometridae first described by Wehrli in 1939.
Lophophelma calaurops | Species of moth | species of insect | Lophophelma calaurops is a moth of the family Geometridae first described by Louis Beethoven Prout in 1912.
Macrobrochis lucida | Species of moth | species of insect | Macrobrochis lucida is a moth of the subfamily Arctiinae. It was described by Fang in 1990.
Macroglossum belis | Species of moth | species of moth | Macroglossum belis, the common hummingbird hawkmoth, is a moth of the family Sphingidae.
Martyringa hoenei | Species of moth | species of insect | Martyringa hoenei is a moth in the family Lecithoceridae. It was described by Alexandr L. Lvovsky in 2010.
Mesastrape fulguraria | Species of moth | species of insect | Mesastrape fulguraria is a moth in the family Geometridae. It is found in Japan, Taiwan and China.
Metriochroa alboannulata | Species of moth | species of insect | Metriochroa alboannulata is a moth of the family Gracillariidae. It is found in China Jiangxi.The wingspan is 6.57.5 mm.
Micrarctia | Genus of moths | genus of insects | Micrarctia is a monotypic tiger moth genus in the family Erebidae described by Seitz in 1910. Its only species, M.
Miltochrista convexa | Species of moth | species of insect | Miltochrista convexa is a moth of the family Erebidae. It was described by Wileman in 1910.
Miltochrista decussata | Species of moth | species of insect | Miltochrista decussata is a moth of the family Erebidae. It was described by Frederic Moore in 1877.
Miltochrista delineata | Species of moth | species of insect | Miltochrista delineata is a moth of the family Erebidae. It was described by Francis Walker in 1854.
Miltochrista fasciata | Species of moth | species of insect | Miltochrista fasciata is a moth of the family Erebidae. It was described by John Henry Leech in 1899.
Miltochrista flexuosa | Species of moth | species of insect | Miltochrista flexuosa is a moth of the family Erebidae. It was described by John Henry Leech in 1899.
Miltochrista inscripta | Species of moth | species of insect | Miltochrista inscripta is a moth of the family Erebidae. It was described by Francis Walker in 1854.
Miltochrista sanguinea | Species of moth | species of insect | Miltochrista sanguinea is a moth of the family Erebidae. It was described by Frederic Moore in 1877.
Miltochrista ziczac | Species of moth | species of insect | Miltochrista ziczac is a moth of the family Erebidae. It was described by Francis Walker in 1856. It is found in China.
Mimicia | Genus of moths | species of insect | Mimicia is a monotypic snout moth genus described by Aristide Caradja in 1925.
Mocis ancilla | Species of moth | species of insect | Mocis ancilla is a species of moth of the family Erebidae.
Mocis annetta | Species of moth | species of insect | Mocis annetta is a species of moth of the family Erebidae.
Mocis inferna | Species of moth | species of insect | Mocis inferna  is a moth of the family Erebidae. It is found in China.
Monema meyi | Species of moth | species of insect | Monema meyi is a moth of the family Limacodidae.
Monema tanaognatha | Species of moth | species of insect | Monema tanaognatha is a moth of the family Limacodidae.
Murzinarctia | Genus of moths | genus of insects | Murzinarctia is a monotypic moth genus in the subfamily Arctiinae.
Murzinoria | Genus of moths | genus of insects | Murzinoria is a monotypic moth genus in the subfamily Arctiinae.
Murzinowatsonia | Genus of moths | genus of insects | Murzinowatsoniia is a monotypic moth genus in the subfamily Arctiinae erected by Vladimir Viktorovitch Dubatolov in 2003
Mustilia zolotuhini | Species of moth | species of insect | Mustilia zolotuhini is a moth in the Endromidae family. It was described by Saldaitis and Ivinskis in 2015.
Nacoleia immundalis | Species of moth | species of insect | Nacoleia immundalis is a moth in the family Crambidae. It was described by South in 1901. It is found in China Hubei.
Nacoleia perstygialis | Species of moth | species of insect | Nacoleia perstygialis is a moth in the family Crambidae. It was described by George Hampson in 1912.
Nacoleia subalbalis | Species of moth | species of insect | Nacoleia subalbalis is a moth in the family Crambidae. It was described by George Hampson in 1912. It is found in China.
Nannoarctia tripartita | Species of moth | species of insect | Nannoarctia tripartita is a moth of the family Erebidae first described by Francis Walker in 1855.
Nematopogon chalcophyllis | Species of moth | species of insect | Nematopogon chalcophyllis is a moth of the family Adelidae or fairy longhorn moths.
Nemophora divina | Species of moth | species of insect | Nemophora divina is a moth of the Adelidae family. It is found in continental China.
Nosophora insignis | Species of moth | species of insect | Nosophora insignis is a moth in the family Crambidae. It was described by Arthur Gardiner Butler in 1881.
Nosphistica fenestrata | Species of moth | species of insect | Nosphistica fenestrata is a moth in the family Lecithoceridae. It is found in Taiwan and southeastern China Fujian.
Nosphistica minutispina | Species of moth |  | Nosphistica minutispina is a moth in the family Lecithoceridae. It was described by Chun-Sheng Wu in 1996.
Nosphistica orientana | Species of moth | species of insect | Nosphistica orientana is a moth in the family Lecithoceridae. It was described by Kyu-Tek Park in 2005.
Nosphistica parameocola | Species of moth | species of insect | Nosphistica parameocola is a moth in the family Lecithoceridae. It is found in Taiwan and southern China Hainan.
Obeidia gigantearia | Species of moth | species of insect | Obeidia gigantearia is a moth of the  family Geometridae. It is found in Taiwan and China.
Oberthueria jiatongae | Species of moth | species of insect | Oberthueria jiatongae is a moth in the Endromidae family.
Oberthueria yandu | Species of moth | species of insect | Oberthueria yandu is a moth in the Endromidae family.
Pachista | Genus of moths | species of insect | Pachista is a genus of moths in the family Geometridae described by Prout in 1912.
Pachyodes amplificata | Species of moth | species of insect | Pachyodes amplificata is a moth of the family Geometridae first described by Francis Walker in 1862.
Pachyodes jianfengensis | Species of moth | species of insect | Pachyodes jianfengensis is a moth of the family Geometridae first described by Hong-Xiang Han and Da-Yong Xue in 2008.
Pachyodes leucomelanaria | Species of moth | species of insect | Pachyodes leucomelanaria  is a moth of the family Geometridae first described by Gustave Arthur Poujade in 1895.
Pachyodes novata | Species of moth | species of insect | Pachyodes novata is a moth of the family Geometridae first described by Hong-Xiang Han and Da-Yong Xue in 2008.
Pachyodes ornataria | Species of moth | species of insect | Pachyodes ornataria is a moth of the family Geometridae first described by Frederic Moore in 1888.
Pachyodes subtritus | Species of moth | species of insect | Pachyodes subtritus is a moth of the family Geometridae first described by Louis Beethoven Prout in 1914.
Palpita curvispina | Species of moth | species of insect | Palpita curvispina is a moth in the family Crambidae. It was described by Zhang and Li in 2005.
Palpita inusitata | Species of moth | species of insect | Palpita inusitata is a moth in the family Crambidae. It was described by Arthur Gardiner Butler in 1879.
Palpita minuscula | Species of moth | species of insect | Palpita minuscula is a moth in the family Crambidae. It was described by Inoue in 1996.
Palpita parvifraterna | Species of moth | species of insect | Palpita parvifraterna is a moth in the family Crambidae. It was described by Inoue in 1999.
Parasa minwangi | Species of moth | species of insect | Parasa minwangi is a moth of the family Limacodidae.
Parasa undulata | Species of moth | species of insect | Parasa undulata is a moth of the family Limacodidae.
Paraspilarctia klapperichi | Species of moth | species of insect | Paraspilarctia klapperichi is a moth of the family Erebidae. It was described by Franz Daniel in 1943.
Paratorna pterofulva | Species of moth | species of moth | Paratorna pterofulva is a species of moth of the family Tortricidae. It is found in China Sichuan.
Paratorna pteropolia | Species of moth | species of moth | Paratorna pteropolia is a species of moth of the family Tortricidae. It is found in China Sichuan.
Patania expictalis | Species of moth | species of insect | Patania expictalis is a moth in the family Crambidae. It was described by Hugo Theodor Christoph in 1881.
Patania iopasalis | Species of moth | species of insect | Patania iopasalis is a moth of the family Crambidae. It was described by Francis Walker in 1859.
Pediasia batangensis | Species of moth | species of insect | Pediasia batangensis is a moth in the family Crambidae. It was described by Aristide Caradja in 1939.
Pediasia dolicanthia | Species of moth | species of insect | Pediasia dolicanthia is a moth in the family Crambidae. It is found in China Xizang.
Pediasia echinulatia | Species of moth | species of insect | Pediasia echinulatia is a moth in the family Crambidae. It is found in China Beijing.
Pediasia jecondica | Species of moth | species of insect | Pediasia jecondica is a moth in the family Crambidae. It was described by Stanisaw Beszyski in 1965.
Pediasia perselloides | Species of moth | species of insect | Pediasia perselloides is a moth in the family Crambidae. It is found in China Zhejiang.
Pediasia yangtseella | Species of moth | species of insect | Pediasia yangtseella is a moth in the family Crambidae. It was described by Aristide Caradja in 1939.
Phalera flavescens | Species of moth | species of insect | Phalera flavescens is a moth of the  family Notodontidae. It is found in Taiwan, China, Japan and Korea.
Phragmataecia innotata | Species of moth | species of insect | Phragmataecia innotata is a species of moth of the family Cossidae.
Phrealcia steueri | Species of moth | species of insect | Phrealcia steueri is a species of moth of the family Ypsolophidae. It is found in Xinjiang, China.
Problepsis conjunctiva | Species of moth | species of insect | Problepsis conjunctiva is a moth of the  family Geometridae. It is found in India Sikkim, China Hainan and Taiwan.
Problepsis eucircota | Species of moth | species of insect | Problepsis eucircota is a moth of the  family Geometridae. It is found in China and Japan.
Problepsis paredra | Species of moth | species of moth | Problepsis paredra is a moth of the  family Geometridae. It is found in western China.
Problepsis phoebearia | Species of moth | species of moth | Problepsis phoebearia is a moth of the family Geometridae described by Nikolay Grigoryevich Erschoff in 1870.
Problepsis subreferta | Species of moth | species of moth | Problepsis subreferta is a moth of the  family Geometridae. It is found in China.
Pseudanabasis | Genus of moths | species of insect | Pseudanabasis is a genus of snout moth. It was described by Y.L. Du, S.M. Song and C.S. Wu in 2009.
Pseudiragoides florianii | Species of moth | species of insect | Pseudiragoides florianii is a species of moth of the family Limacodidae.
Pseudiragoides itsova | Species of moth | species of insect | Pseudiragoides itsova is a species of moth of the family Limacodidae.
Pseudostegania distinctaria | Species of moth | species of insect | Pseudostegania distinctaria is a moth in the family Geometridae. It is found in China Sichuan.
Pseudostegania lijiangensis | Species of moth | species of insect | Pseudostegania lijiangensis is a moth in the family Geometridae. It is found in China Yunnan.
Pseudostegania qinlingensis | Species of moth | species of insect | Pseudostegania qinlingensis is a moth in the family Geometridae. It is found in China Gansu, Shaanxi.
Pseudostegania straminearia | Species of moth | species of insect | Pseudostegania straminearia is a moth in the family Geometridae. It is found in China Sichuan.
Pseudostegania yargongaria | Species of moth | species of insect | Pseudostegania yargongaria is a moth in the family Geometridae. It is found in China.
Pseudostegania zhoui | Species of moth | species of insect | Pseudostegania zhoui is a moth in the family Geometridae. It is found in China Sichuan.
Pycnarmon chinensis | Species of moth | species of insect | Pycnarmon chinensis is a moth in the family Crambidae. It was described by South in 1901. It is found in China.
Pycnarmon geminipuncta | Species of moth | species of insect | Pycnarmon geminipuncta is a moth in the family Crambidae. It was described by George Hampson in 1912.
Pycnarmon radiata | Species of moth | species of insect | Pycnarmon radiata is a moth in the family Crambidae. It was described by William Warren in 1896.
Pyrausta bieti | Species of moth | species of insect | Pyrausta bieti is a moth in the family Crambidae. It was described by Oberthr in 1886. It is found in China Sichuan.
Pyrausta contigualis | Species of moth | species of insect | Pyrausta contigualis is a moth in the family Crambidae. It was described by South in 1901. It is found in China Sichuan.
Pyrausta contristalis | Species of moth | species of insect | Pyrausta contristalis is a moth in the family Crambidae. It was described by Aristide Caradja in 1932.
Pyrausta curvalis | Species of moth | species of insect | Pyrausta curvalis is a moth in the family Crambidae. It was described by John Henry Leech in 1889. It is found in China.
Pyrausta draesekei | Species of moth | species of insect | Pyrausta draesekei is a moth in the family Crambidae. It was described by Aristide Caradja in 1927.
Pyrausta ecteinalis | Species of moth | species of insect | Pyrausta ecteinalis is a moth in the family Crambidae. It was described by George Hampson in 1900.
Pyrausta genialis | Species of moth | species of insect | Pyrausta genialis is a moth in the family Crambidae. It was described by South in 1901. It is found in China.
Pyrausta griseocilialis | Species of moth | species of insect | Pyrausta griseocilialis is a moth in the family Crambidae. It was described by South in 1901. It is found in China.
Pyrausta hampsoni | Species of moth | species of insect | Pyrausta hampsoni is a moth in the family Crambidae. It was described by South in 1901. It is found in China.
Pyrausta leechi | Species of moth | species of insect | Pyrausta leechi is a moth in the family Crambidae. It was described by South in 1901. It is found in China.
Pyrausta mandarinalis | Species of moth | species of insect | Pyrausta mandarinalis is a moth in the family Crambidae. It was described by South in 1901.
Pyrausta moupinalis | Species of moth | species of insect | Pyrausta moupinalis is a moth in the family Crambidae. It was described by South in 1901. It is found in China Sichuan.
Pyrausta mystica | Species of moth | species of insect | Pyrausta mystica is a moth in the family Crambidae. It was described by Aristide Caradja in 1932.
Pyrausta oberthuri | Species of moth | species of insect | Pyrausta oberthuri is a moth in the family Crambidae. It was described by South in 1901. It is found in China Sichuan.
Pyrausta obstipalis | Species of moth | species of insect | Pyrausta obstipalis is a moth in the family Crambidae. It was described by South in 1901. It is found in China.
Pyrausta odontogrammalis | Species of moth | species of insect | Pyrausta odontogrammalis is a moth in the family Crambidae. It was described by Aristide Caradja in 1925.
Pyrausta persimilis | Species of moth | species of insect | Pyrausta persimilis is a moth in the family Crambidae. It was described by Aristide Caradja in 1932.
Pyrausta postalbalis | Species of moth | species of insect | Pyrausta postalbalis is a moth in the family Crambidae. It was described by South in 1901. It is found in China.
Pyrausta punctilinealis | Species of moth | species of insect | Pyrausta punctilinealis is a moth in the family Crambidae. It was described by South in 1901.
Pyrausta quadrimaculalis | Species of moth | species of insect | Pyrausta quadrimaculalis is a moth in the family Crambidae. It was described by South in 1901.
Pyrausta rectifascialis | Species of moth | species of insect | Pyrausta rectifascialis is a moth in the family Crambidae. It was described by Sauber in 1899. It is found in China.
Pyrausta rueckbeili | Species of moth | species of insect | Pyrausta rueckbeili is a moth in the family Crambidae. It was described by Sauber in 1899. It is found in China.
Pyrausta rufalis | Species of moth | species of insect | Pyrausta rufalis is a moth in the family Crambidae. It was described by South in 1901. It is found in China Sichuan.
Pyrausta splendida | Species of moth | species of insect | Pyrausta splendida is a moth in the family Crambidae. It was described by Aristide Caradja in 1938.
Pyrausta strigatalis | Species of moth | species of insect | Pyrausta strigatalis is a moth in the family Crambidae. It was described by Aristide Caradja in 1937.
Pyrausta subfuscalis | Species of moth | species of insect | Pyrausta subfuscalis is a moth in the family Crambidae. It was described by Aristide Caradja in 1933.
Pyrausta sumptuosalis | Species of moth | species of insect | Pyrausta sumptuosalis is a moth of the family Crambidae. It is found in Sichuan, China.
Pyrausta syfanialis | Species of moth | species of insect | Pyrausta syfanialis is a moth in the family Crambidae. It was described by Oberthr in 1893. It is found in China Tibet.
Pyrausta szetschwanalis | Species of moth | species of insect | Pyrausta szetschwanalis is a moth in the family Crambidae. It was described by Aristide Caradja in 1927.
Pyrausta tapaishanensis | Species of moth | species of insect | Pyrausta tapaishanensis is a moth in the family Crambidae. It was described by Aristide Caradja in 1939.
Pyrausta thibetalis | Species of moth | species of insect | Pyrausta thibetalis is a moth in the family Crambidae. It was described by Oberthr in 1886.
Pyrausta tortualis | Species of moth | species of insect | Pyrausta tortualis is a moth in the family Crambidae. It was described by South in 1901. It is found in China.
Pyrausta tschelialis | Species of moth | species of insect | Pyrausta tschelialis is a moth in the family Crambidae. It was described by Aristide Caradja in 1927.
Pyrausta zeitunalis | Species of moth | species of insect | Pyrausta zeitunalis is a moth in the family Crambidae. It was described by Aristide Caradja in 1916.
Rhagoba obvellata | Species of moth | species of insect | Rhagoba obvellata is a moth in the family Crambidae. It was described by Xi-Cui Du and Hou-Hun Li in 2012.
Rivula curvifera | Species of moth | species of insect | Rivula curvifera is a moth of the family Erebidae first described by Francis Walker in 1862.
Sciota obscurella | Species of moth | species of insect | Sciota obscurella is a species of snout moth. It is found in China Yunnan.
Scirpophaga adunctella | Species of moth | species of insect | Scirpophaga adunctella is a moth in the family Crambidae.
Scirpophaga auristrigellus | Species of moth | species of insect | Scirpophaga auristrigellus is a moth in the family Crambidae. It was described by George Hampson in 1896.
Scirpophaga gotoi | Species of moth | species of insect | Scirpophaga gotoi is a moth in the family Crambidae. It was described by Angoon Lewvanich in 1981.
Scirpophaga humilis | Species of moth | species of insect | Scirpophaga humilis is a moth in the family Crambidae. It was described by Wang, Li and Chen in 1986.
Scirpophaga khasis | Species of moth | species of insect | Scirpophaga khasis is a moth in the family Crambidae. It was described by Angoon Lewvanich in 1981.
Scirpophaga linguatella | Species of moth | species of insect | Scirpophaga linguatella is a moth in the family Crambidae.
Scirpophaga parvalis | Species of moth | species of insect | Scirpophaga parvalis is a moth in the family Crambidae. It was described by Alfred Ernest Wileman in 1911.
Scirpophaga whalleyi | Species of moth | species of insect | Scirpophaga whalleyi is a moth in the family Crambidae. It was described by Angoon Lewvanich in 1981.
Scythropiodes tribula | Species of moth | species of insect | Scythropiodes tribula is a moth in the family Lecithoceridae. It was described by Chun-Sheng Wu in 1997.
Semiothisa cinerearia | Species of moth | species of insect | Semiothisa cinerearia is a moth of the family Geometridae first described by Otto Vasilievich Bremer and Vasilii Fomich
Spatulignatha arcuata | Species of moth | species of insect | Spatulignatha arcuata is a moth in the family Lecithoceridae. It is found in China Guangdong, Hunan, Yunnan.
Spatulignatha chrysopteryx | Species of moth | species of insect | Spatulignatha chrysopteryx is a moth in the family Lecithoceridae. It is found in China.
Spatulignatha longizonalis | Species of moth | species of insect | Spatulignatha longizonalis is a moth in the family Lecithoceridae. It is found in China Guangxi.
Spilarctia nydia | Species of moth | species of insect | Spilarctia nydia is a moth in the family Erebidae. It was described by Arthur Gardiner Butler in 1875.
Spilarctia zhangmuna | Species of moth | species of insect | Spilarctia zhangmuna is a moth in the family Erebidae. It was described by Cheng-Lai Fang in 1982.
Spilosoma erythrozona | Species of moth | species of insect | Spilosoma erythrozona is a moth in the family Erebidae. It was described by Vincenz Kollar in 1844.
Stegasta variana | Species of moth | species of insect | Stegasta variana is a species of moth of the family Gelechiidae.
Stigmatophora acerba | Species of moth | species of insect | Stigmatophora acerba is a moth in the family Erebidae. It was described by John Henry Leech in 1899.
Stigmatophora chekiangensis | Species of moth | species of insect | Stigmatophora chekiangensis is a moth in the subfamily Arctiinae. It was described by Franz Daniel in 1951.
Stigmatophora confusa | Species of moth | species of insect | Stigmatophora confusa is a moth in the subfamily Arctiinae. It was described by Franz Daniel in 1951.
Stigmatophora conjuncta | Species of moth | species of insect | Stigmatophora conjuncta is a moth in the subfamily Arctiinae. It was described by Cheng-Lai Fang in 1991.
Stigmatophora grisea | Species of moth | species of insect | Stigmatophora grisea is a moth in the subfamily Arctiinae. It was described by Hering in 1936.
Stigmatophora hainanensis | Species of moth | species of insect | Stigmatophora hainanensis is a moth in the subfamily Arctiinae. It was described by Cheng-Lai Fang in 1991.
Stigmatophora likiangensis | Species of moth | species of insect | Stigmatophora likiangensis is a moth in the subfamily Arctiinae. It was described by Franz Daniel in 1951.
Stigmatophora obraztsovi | Species of moth | species of insect | Stigmatophora obraztsovi is a moth in the subfamily Arctiinae. It was described by Franz Daniel in 1951.
Stigmatophora rubivena | Species of moth | species of insect | Stigmatophora rubivena is a moth in the subfamily Arctiinae. It was described by Cheng-Lai Fang in 1991.
Stigmella circumargentea | Species of moth | species of insect | Stigmella circumargentea is a moth of the family Nepticulidae. It is only known from Yunnan.The wingspan is about 6.
Stigmella fervida | Species of moth | species of insect | Stigmella fervida is a moth of the family Nepticulidae. It is found in Russia Primorskiy Kray and China Heilongjiang.
Stigmella kao | Species of moth | species of insect | Stigmella kao is a moth of the family Nepticulidae. It is only known from Yunnan, China.The wingspan is .
Stigmella lithocarpella | Species of moth | species of insect | Stigmella lithocarpella is a moth of the family Nepticulidae. It is only known from Yunnan.The wingspan is about 6.1 mm.
Stigmella vandrieli | Species of moth | species of insect | Stigmella vandrieli is a moth of the family Nepticulidae. It is only known from Yunnan, China.The wingspan is 4.9-5.
Streltzovia | Genus of moths | genus of insects | Streltzovia is a genus of moths in the subfamily Arctiinae from East Asia.
Syllepte amoyalis | Species of moth | species of insect | Syllepte amoyalis is a moth in the family Crambidae. It was described by Aristide Caradja in 1925. It is found in China.
Syllepte capnosalis | Species of moth | species of insect | Syllepte capnosalis is a moth in the family Crambidae. It was described by Aristide Caradja in 1925.
Syllepte fuscoinvalidalis | Species of moth | species of insect | Syllepte fuscoinvalidalis is a moth in the family Crambidae. It was described by Hiroshi Yamanaka in 1959.
Syllepte fuscomarginalis | Species of moth | species of insect | Syllepte fuscomarginalis is a moth in the family Crambidae. It was described by John Henry Leech in 1889.
Syllepte hoenei | Species of moth | species of insect | Syllepte hoenei is a moth in the family Crambidae. It was described by Aristide Caradja in 1925. It is found in China.
Syllepte invalidalis | Species of moth | species of insect | Syllepte invalidalis is a moth in the family family Crambidae. It was described by South in 1901. It is found in China.
Syllepte lucidalis | Species of moth | species of insect | Syllepte lucidalis is a moth in the family Crambidae. It was described by Aristide Caradja in 1925.
Syllepte ningpoalis | Species of moth | species of insect | Syllepte ningpoalis is a moth in the family Crambidae. It was described by John Henry Leech in 1889.
Syllepte pallidinotalis | Species of moth | species of insect | Syllepte pallidinotalis is a moth in the family Crambidae. It was described by George Hampson in 1912.
Syllepte proctizonalis | Species of moth | species of insect | Syllepte proctizonalis is a moth in the family Crambidae. It was described by George Hampson in 1918.
Syllepte rhyparialis | Species of moth | species of insect | Syllepte rhyparialis is a moth in the family Crambidae. It was described by Oberthr in 1893. It is found in China.
Synersaga breviclavata | Species of moth |  | Synersaga breviclavata is a moth in the family Lecithoceridae. It is found in China Shaanxi.
Synersaga brevidigitata | Species of moth |  | Synersaga brevidigitata is a moth in the family Lecithoceridae. It is found in China Yunnan.
Talis cornutella | Species of moth | species of insect | Talis cornutella is a moth in the family Crambidae. It is found in China Xinjiang.
Talis erenhotica | Species of moth | species of insect | Talis erenhotica is a moth in the family Crambidae. It is found in China Inner Mongolia.
Talis qinghaiella | Species of moth | species of insect | Talis qinghaiella is a moth in the family Crambidae. It is found in China Qinghai.
Teliphasa erythrina | Species of moth | species of insect | Teliphasa erythrina is a species of moth of the family Pyralidae. It is found in China Yunnan.
Teliphasa hamata | Species of moth | species of insect | Teliphasa hamata is a species of moth of the family Pyralidae. It is found in China Fujian, Guangxi, Yunnan.
Teliphasa similalbifusa | Species of moth | species of insect | Teliphasa similalbifusa is a species of moth of the family Pyralidae. It is found in China Guangxi.
Thitarodes baimaensis | Species of moth | species of insect | Thitarodes baimaensis is a species of moth of the family Hepialidae.
Thitarodes bibelteus | Species of moth | species of insect | Thitarodes bibelteus is a species of moth of the family Hepialidae. It is found in Yunnan, China.
Thitarodes biruensis | Species of moth | species of insect | Thitarodes biruensis is a species of moth of the family Hepialidae. It is found in Xizang, China.
Thitarodes deqinensis | Species of moth | species of insect | Thitarodes deqinensis is a species of moth of the family Hepialidae. It is found in Yunnan, China.
Thitarodes latitegumenus | Species of moth | species of insect | Thitarodes latitegumenus is a species of moth of the family Hepialidae. It is found in Yunnan, China.
Thitarodes pui | Species of moth | species of insect | Thitarodes pui is a species of moth of the family Hepialidae. It is found in Tibet, China.
Tortrix sinapina | Species of moth | species of insect | Tortrix sinapina, the Japanese oak leafroller, is a species of moth of the family Tortricidae.
Trichophysetis aurantidiscalis | Species of moth | species of insect | Trichophysetis aurantidiscalis is a moth in the family Crambidae. It is found in China.
Trichophysetis bipunctalis | Species of moth | species of insect | Trichophysetis bipunctalis is a moth in the family Crambidae. It is found in China.
Trichophysetis hampsoni | Species of moth | species of insect | Trichophysetis hampsoni is a moth in the family Crambidae. It is found in China.
Trifurcula sinica | Species of moth | species of insect | Trifurcula sinica is a moth of the family Nepticulidae. It was described by Yang in 1989.
Udea albostriata | Species of moth | species of insect | Udea albostriata is a moth in the family Crambidae. It was first described by Zhang and Li in 2016.
Udea curvata | Species of moth | species of insect | Udea curvata is a moth in the family Crambidae. It was first described by Zhang and Li in 2016.
Ugia insuspecta | Species of moth | species of insect | Ugia insuspecta is a species of moth in the family Erebidae.
Vladimirea krasilnikovae | Species of moth | species of insect | Vladimirea krasilnikovae is a moth in the family Gelechiidae. It was described by Alexandr L. Lvovsky and Vladimir I.
Xestia caelebs | Species of moth | species of insect | Xestia caelebs is a moth of the family Noctuidae. It is known from Xinjiang.
Ypsolopha atrobrunnella | Species of moth | species of insect | Ypsolopha atrobrunnella is a moth of the family Ypsolophidae.
Ypsolopha costibasella | Species of moth | species of insect | Ypsolopha costibasella is a moth of the family Ypsolophidae.
Ypsolopha diana | Species of moth | species of insect | Ypsolopha diana is a moth of the family Ypsolophidae. It is known from China.
Ypsolopha helva | Species of moth | species of insect | Ypsolopha helva is a moth of the family Ypsolophidae. It is known from north-western China.
Ypsolopha lutisplendida | Species of moth | species of insect | Ypsolopha lutisplendida is a moth of the family Ypsolophidae. It is known from north-western China.
Ypsolopha melanocnista | Species of moth | species of insect | Ypsolopha melanocnista is a moth of the family Ypsolophidae. It is known from Yunnan in China.
Ypsolopha mienshani | Species of moth | species of insect | Ypsolopha mienshani is a moth of the family Ypsolophidae. It is known from Shanxi in China.
Ypsolopha parodaula | Species of moth | species of insect | Ypsolopha parodaula is a moth of the family Ypsolophidae. It is known from Yunnan in China.
Ypsolopha rhytidota | Species of moth | species of insect | Ypsolopha rhytidota is a moth of the family Ypsolophidae. It is known from Yunnan in China.
Ypsolopha sordida | Species of moth | species of insect | Ypsolopha sordida is a moth of the family Ypsolophidae. It is known from southern China.
Ypsolopha yangi | Species of moth | species of insect | Ypsolopha yangi is a moth of the family Ypsolophidae.
Zebronia ornatalis | Species of moth | species of insect | Zebronia ornatalis is a moth in the family Crambidae. It was described by John Henry Leech in 1889.
